Added 	 增加
Deleted 	 删除
Modified 	 修改
\.\.\. and ([,0-9]+) more\.	 ... 其他$1项目
$1000	¥30000
% of audit items fail	%审计项目失败
% of requests time out	%请求超时
(.*)[Hh]iding (HTML, )?(script, )?(XML, )?(CSS, )?(HTML|script|XML|CSS|flash) content(.*)	$1隐藏$2$3$4$5$6内容$7
(.*)[Hh]iding (HTML, )?(script, )?(XML, )?(CSS, )?flash and general binary content(.*)	$1隐藏$2$3$4$5flash和一般二进制内容$6
(.*)[Hh]iding (HTML, )?(script, )?(XML, )?(CSS, )?general binary content(.*)	$1隐藏$2$3$4$5一般二进制内容$6
(.*)[Hh]iding (HTML, )?(script, )?(XML, )?(CSS, )?general text and flash content(.*)	$1隐藏$2$3$4$5一般文本和flash内容$6
(.*)[Hh]iding (HTML, )?(script, )?(XML, )?(CSS, )?general text and image content(.*)	$1隐藏$2$3$4$5一般文本和图像内容$6
(.*)[Hh]iding (HTML, )?(script, )?(XML, )?(CSS, )?general text content(.*)	$1隐藏$2$3$4$5一般文本内容$6
(.*)[Hh]iding (HTML, )?(script, )?(XML, )?(CSS, )?general text(, flash)? and general binary content(.*)	$1隐藏$2$3$4$5一般文本$6和一般二进制内容$7
(.*)[Hh]iding (HTML, )?(script, )?(XML, )?(CSS, )?general text, image and flash content(.*)	$1隐藏$2$3$4$5一般文本，图片和flash内容$6
(.*)[Hh]iding (HTML, )?(script, )?(XML, )?(CSS, )?general text, image(, flash)? and general binary content(.*)	$1隐藏$2$3$4$5一般文本，图片$6和一般二进制内容$7
(.*)[Hh]iding (HTML, )?(script, )?(XML, )?(CSS, )?image and flash content(.*)	$1隐藏$2$3$4$5图片和flash内容$6
(.*)[Hh]iding (HTML, )?(script, )?(XML, )?(CSS, )?image content(.*)	$1隐藏$2$3$4$5图片内容$6
(.*)[Hh]iding (HTML, )?(script, )?(XML, )?(CSS, )?image(, flash)? and general binary content(.*)	$1隐藏$2$3$4$5图片$6和一般二进制内容$7
(.*)[Hh]iding (HTML|script|XML|CSS)(, script)?(, XML)?(, CSS)? and (script|XML|CSS|flash) content(.*)	$1隐藏$2$3$4$5和$6内容7
(.*)[Hh]iding (HTML|script|XML|CSS)(, script)?(, XML)?(, CSS)? and general binary content(.*)	$1隐藏$2$3$4$5和一般二进制内容$6
(.*)[Hh]iding (HTML|script|XML|CSS)(, script)?(, XML)?(, CSS)? and general text content(.*)	$1隐藏$2$3$4$5和一般文本内容$6
(.*)[Hh]iding (HTML|script|XML|CSS)(, script)?(, XML)?(, CSS)? and image content(.*)	$1隐藏$2$3$4$5和图片内容$6
(.*)[Hh]iding ([2-5]xx) responses(.*)	$1$2隐藏响应$3
(.*)[Hh]iding ([2-5]xx, )?([2-5]xx, )?((, )?[2-5]xx) and ([2-5]xx) responses(.*)	$1隐藏$2$3$4$5和$6响应$7
(.*)[Hh]iding empty folders(.*)	$1隐藏空文件夹$2
(.*)[Hh]iding incoming items(.*)	$1隐藏已接收项目$2
(.*)[Hh]iding non-parameterized and not found items(.*)	$1隐藏无参数和不存在的项目$2
(.*)[Hh]iding non-parameterized items(.*)	$1隐藏无参数项目$2
(.*)[Hh]iding not found items(.*)	$1隐藏不存在的项目$2
(.*)[Hh]iding out of scope and incoming items(.*)	$1隐藏超出范围的已接收项目$2
(.*)[Hh]iding out of scope and non-parameterized items(.*)	$1隐藏超出范围的无参数项目$2
(.*)[Hh]iding out of scope and not found items(.*)	$隐藏超出范围的不存在项目$2
(.*)[Hh]iding out of scope and outgoing items(.*)	$隐藏超出范围的已发送项目$2
(.*)[Hh]iding out of scope and unrequested items(.*)	$隐藏超出范围的无请求项目$2
(.*)[Hh]iding out of scope and unresponded items(.*)	$1隐藏超出范围的无响应项目$2
(.*)[Hh]iding out of scope items(.*)	$1隐藏超出范围的项目$2
(.*)[Hh]iding out of scope, non-parameterized and not found items(.*)	$1隐藏超出范围、无参数及不存在的项目$2
(.*)[Hh]iding out of scope, outgoing and incoming items(.*)	$隐藏超出范围、已接收及已发送的项目$2
(.*)[Hh]iding out of scope, unrequested and non-parameterized items(.*)	$1隐藏超出范围、无请求及无参数的项目$2
(.*)[Hh]iding out of scope, unrequested and not found items(.*)	$1隐藏超出范围、无请求及不存在的项目$2
(.*)[Hh]iding out of scope, unrequested, non-parameterized and not found items(.*)	$1隐藏超出范围、无请求、无参数及不存在的项目$2
(.*)[Hh]iding out of scope, unresponded and non-parameterized items(.*)	$1隐藏超出范围、无响应及无参数的项目$2
(.*)[Hh]iding outgoing and incoming items(.*)	$1隐藏已发送和已接收的项目$2
(.*)[Hh]iding outgoing items(.*)	$1隐藏已发送的项目$2
(.*)[Hh]iding specific extensions(.*)	$1隐藏指定的扩展名$2
(.*)[Hh]iding unrequested and non-parameterized items(.*)	$1隐藏无请求及无参数的项目$2
(.*)[Hh]iding unrequested and not found items(.*)	$1隐藏无请求及不存在的项目$2
(.*)[Hh]iding unrequested items(.*)	$1隐藏无请求的项目$2
(.*)[Hh]iding unrequested, non-parameterized and not found items(.*)	$1隐藏无请求、无参数及不存在的项目$2
(.*)[Hh]iding unresponded and non-parameterized items(.*)	$1隐藏无响应及无参数项目$2
(.*)[Hh]iding unresponded items(.*)	$1隐藏无响应项目$2
(.*)[Mm]atching expression (.*)	$1匹配表达式 $2
(.*)[Mm]atching regex (.*)	$1匹配正则 $2
(.*)[Nn]ot matching expression (.*)	$1不匹配表达式$2
(.*)[Nn]ot matching regex (.*)	$1不匹配正则$2
(.*)[Ss]howing only commented and highlighted items(.*)	$1仅显示带注释及高亮的项目$2
(.*)[Ss]howing only commented items(.*)	$1仅显示带注释的项目$2
(.*)[Ss]howing only highlighted items(.*)	$1仅显示高亮的项目$2
(.*)[Ss]howing only listener (.*)	$1仅显示侦听器(listener)$2
(.*)[Ss]howing specific extensions(.*)	$1显示指定的扩展名$2
(.*)\[Pro version only\](.*)	$1[仅限专业版]$2
(.*)\[Pro version with 64-bit Java only\](.*)	$1[仅限64位Java的专业版]$2
(.*)\[disk projects only\](.*)	$1[仅限磁盘项目]$2
(.*: )excellent.	$1非常好。
(.*: )extremely poor.	$1非常糟糕。
(.*: )poor.	$1比较差。
(.*: )reasonable.	$1合理的。
(.*: )very good.	$1非常好。
(.*: )very poor.	$1非常差。
(Leave blank to run once only)	(如果您只想运行一次，请留空)
([,0-9]+) bytes \| ([0-9]+) millis	$1字节 | $2毫秒
([,0-9]+) bytes?	$1字节
([,0-9]+) highlights?	$1高亮
([,0-9]+) issues selected	$1选择问题
([,0-9]+) items selected	$1选择项目
([,0-9]+) results selected	$1选择结果
([,0-9]+) submissions?	$1提交
([0-9]+) \(approx\)	约$1
([0-9]+) \(max\)	$1 (最大)
([0-9]+) anomalies were identified in this test:	在此测试中发现了异常:
([0-9]+) bits failed the test. The following ([0-9]+) bits passed the test: ([0-9]+)(, [0-9]+)*.(.*)	$1bits 测试失败 以下$2 位成功通过测试 $3$4$5
([0-9]+) bits passed the test. The following ([0-9]+) bits failed the test: ([0-9]+)(, [0-9]+)*.(.*)	$1bits 通过了测试。以下$2位未能通过测试: $3$4$5
([0-9]+) items added to site map	项目已添加到站点地图中
([0-9]+) items?	$1项目
([0-9]+) letter words	$1字母词
([0-9]+) locations crawled	$1目录爬行
([0-9]+) payload positions?	$1payload 位置？
([0-9]+) requests \(([0-9]+) errors\)	$1请求($2错误)
([0-9]+) responses processed	$1响应处理
([0-9]+) responses queued	$1响应添加到队列中
([0-9]+) results?	$1结果
([0-9]+) tokens were padded with (.*) at the end.	$1令牌(tokens)在最后使用$2填充。
([0-9]+) tokens were padded with (.*) at the start.	$1令牌(tokens)在开始时用$2填充。
([0-9]+)% complete	$1%完成
([0-9]+)\. Audit of (.*)	$1. $2 的审计
([0-9]+)\. Crawl and audit of (.*)	$1. $2 的爬行和审计
([0-9]+)\. Crawl of (.*)	$1. $2 的爬行
([0-9]+)\. Live audit from (Proxy|Repeater) and (Repeater|Intruder) \(all traffic\)	$1. 来自 $2 和 $3 模块的实时审计（所有流量）
([0-9]+)\. Live audit from (Proxy|Repeater) and (Repeater|Intruder) \(custom scope\)	$1. 来自 $2 和 $3 模块的实时审计（自定义范围）
([0-9]+)\. Live audit from (Proxy|Repeater) and (Repeater|Intruder) \(suite scope\)	$1. 来自 $2 和 $3 模块的实时审计（套件范围）
([0-9]+)\. Live audit from (Proxy|Repeater|Intruder) \(all traffic\)	$1. 来自 $2 模块的实时审计（所有流量）
([0-9]+)\. Live audit from (Proxy|Repeater|Intruder) \(custom scope\)	$1. 来自 $2 模块的实时审计（自定义范围）
([0-9]+)\. Live audit from (Proxy|Repeater|Intruder) \(suite scope\)	$1. 来自 $2 模块的实时审计（套件范围）
([0-9]+)\. Live audit from Proxy, Repeater and Intruder \(all traffic\)	$1. 来自 Proxy,重放器,攻击器 模块的实时审计（所有流量）
([0-9]+)\. Live audit from Proxy, Repeater and Intruder \(custom scope\)	$1. 来自 Proxy,重放器,攻击器 模块的实时审计（自定义范围）
([0-9]+)\. Live audit from Proxy, Repeater and Intruder \(suite scope\)	$1. 来自 Proxy,重放器,攻击器 模块的实时审计（套件范围）
([0-9]+)\. Live passive crawl from (Proxy|Repeater) and (Repeater|Intruder) \(all traffic\)	$1. 来自 $2 和 $3 模块的实时被动爬行（所有流量）
([0-9]+)\. Live passive crawl from (Proxy|Repeater) and (Repeater|Intruder) \(custom scope\)	$1. 来自 $2 和 $3 模块的实时被动爬行（自定义范围）
([0-9]+)\. Live passive crawl from (Proxy|Repeater) and (Repeater|Intruder) \(suite scope\)	$1. 来自 $2 和 $3 模块的实时被动爬行（套件范围）
([0-9]+)\. Live passive crawl from (Proxy|Repeater|Intruder) \(all traffic\)	$1. 来自 $2 模块的实时被动爬行（所有流量）
([0-9]+)\. Live passive crawl from (Proxy|Repeater|Intruder) \(custom scope\)	$1. 来自 $2 模块的实时被动爬行（自定义范围）
([0-9]+)\. Live passive crawl from (Proxy|Repeater|Intruder) \(suite scope\)	$1. 来自 $2 模块的实时被动爬行（套件范围）
([0-9]+)\. Live passive crawl from Proxy, Repeater and Intruder \(all traffic\)	$1. 来自 Proxy,重放器,攻击器 模块的实时被动爬行（所有流量）
([0-9]+)\. Live passive crawl from Proxy, Repeater and Intruder \(custom scope\)	$1. 来自 Proxy,重放器,攻击器 模块的实时被动爬行（自定义范围）
([0-9]+)\. Live passive crawl from Proxy, Repeater and Intruder \(suite scope\)	$1. 来自 Proxy,重放器,攻击器 模块的实时被动爬行（套件范围）
([0-9]+)h ([0-9]+)m ([0-9]+)s	$1时间 $2分 $3秒
([0-9]+)m ([0-9]+)s	$1分 $2秒
([0-9]+)s	$1秒
([1-9][0-9]*) match(es)?	$1匹配
([A-Z]+) request to (.*)	$2 的 $1 请求
0 matches	没有匹配
0 positions	没有位置
1 (LSB)	1(最重要的一点)
1. Click the "Copy Clickbandit to clipboard" button below. This will copy the Clickbandit script to your clipboard.	1.单击下面的“将Clickbandit复制到剪贴板”按钮。 这会将Clickbandit脚本复制到剪贴板。
1. Using your browser, go to the following URL:	1.使用浏览器，转到以下URL：
2. Copy the following data into the activation request field in your browser:	2.将以下数据复制到浏览器的激活请求字段：
2. In your browser, visit the web page that you want to test, in the usual way.	2.在浏览器中，像平常一样访问要测试的网页。
2xx  [success]	2xx  [成功]
3. In your browser, open the web developer console. This might also be called "developer tools" or "JavaScript console".	3.在浏览器中，打开Web开发人员控制台。 这也称为“开发人员工具”或“JavaScript控制台”。
3. Paste below the data from the activation response field in your browser:	3.从浏览器的激活响应字段中，粘贴下一个数据：
3xx  [redirection]	3xx  [重定向]
3xx status code with Location header	带Location头部的3xx状态代码
4. Paste the Clickbandit script into the web developer console, and press enter.	4.将Clickbandit脚本粘贴到Web开发人员控制台中，然后按Enter键。
4xx  [request error]	4xx  [请求错误]
5xx  [server error]	5xx  [服务器错误]
8 (MSB)	8(最重要的一点)
A backup of the project has been found, please indicate whether you would like to attempt a repair of the project or open the backup.	找到了一个项目的备份。 请指定是修复项目还是打开备份文件。
A built-in configuration has the same name	已经有一个内置的设置使用了相同的名字。
A communications error occurred. Please review your connection settings and retry, or attempt to perform manual activation.	发生了一个通信错误。 请检查连接设置并重试，或执行手动激活。
A macro is a sequence of one or more requests. You can use macros within session handling rules to perform tasks such as logging in to the application, obtaining anti-CSRF tokens, etc.	宏是一个或多个请求的序列。 您可以在会话处理规则中使用宏来执行诸如登录应用程序和获取CSRF明天令牌等任务。
A new version of Burp is available.	一个新版本的Burp已经可以获取。
A resource pool is a grouping of tasks that share a quota of network resources. Each resource pool can be configured with its own throttling settings which control the number of requests that can be made concurrently, or the rate at which requests can be made, or both.	资源池是一组共享网络资源分配的任务。 可以将每个资源池配置为调整并发请求数，请求速度或两者。
AMF string parameters (use with caution)	AMF字符串参数（请谨慎使用）
AMF version(\s*)	AMF版本$1
API Keys	API键
API key is only available at time of initial generation	API密钥仅在初始创建时可用
API keys are secrets and should be handled carefully. You cannot retrieve an existing API key from Burp after it has been created.	API密钥是保密的，需要谨慎对待。 创建后无法从Burp获取API密钥。
APIs	API
ASCII hex	ASCII十六进制数
ASP.NET ViewState without MAC enabled(\s+\[[0-9]+\])?	MAC无效 ASP.NET ViewState$1
ASP.NET debugging enabled(\s+\[[0-9]+\])?	ASP.NET调试已启用$1
ASP.NET tracing enabled(\s+\[[0-9]+\])?	ASP.NET跟踪已启用$1
About	Burp Suite 关于Burp Suite
About Burp Scanner	关于Burp Scanner
Accept cookies	接受cookie
Action	动作
Action URL	目标 URL
Action URL and method	目标网址和方法
Action URL, method and fields	目标网址，方法，字段
Action URL, method, fields and values	目标网址，方法，字段，值
Action URL:	目标URL:
Activate License	激活许可证
Activation Failed	激活失败
Active Scanning Areas	主动扫描区域
Active Scanning Engine	主动扫描引擎
Active Scanning Optimization	主动扫描优化
Active and passive scanning	主动和被动扫描
Active checks	主动检查
Active phases	活跃期
Active scanning only	仅限主动扫描
Active scanning wizard	主动扫描向导
Actively scan all in-scope traffic through Proxy	主动扫描通过Proxy的所有范围内流量
Actively scan defined insertion points	主动扫描定义的插入点
Actively scan selected items	主动扫描所选项目
Actively scan this branch	主动扫描此分支
Actively scan this host	主动扫描此主机
Add	添加
Add "skip parameter" rule	添加“跳过参数”规则
Add % prefix before each byte	在每个字节前添加％
Add SSL passthrough target	添加SSL穿透的目标
Add URL to exclude from scope	添加要从范围中排除的URL
Add URL to include in scope	添加要包括在范围中的URL
Add a new action	添加一个新动作
Add a new client certificate	添加一个新的客户端证书
Add a new custom parameter location	添加自定义参数位置
Add a new extract item	添加新提取的项目
Add a new form field completion rule	添加了新表单字段完成规则
Add a new header	添加新头部
Add a new interception rule	添加新的拦截规则
Add a new item	添加新项目
Add a new item by pasting a URL	粘贴网址并添加新项目
Add a new listener	添加一个侦听器
Add a new macro	添加一个新的宏
Add a new match/replace rule	添加一个新的匹配/替换规则
Add a new parameter	添加一个新参数
Add a new payload processing rule	添加一个新的有效载荷处理规则
Add a new proxy listener	添加一个新的代理侦听器
Add a new task	添加新任务
Add a new upstream proxy rule	添加一条新的上行代理规则
Add all items requested through Proxy to site map	通过代理将请求的所有项目添加到Sitemap中
Add all links observed in traffic through Proxy to site map	将通过代理服务器观察到的所有链接添加到Sitemap
Add comment	添加评论
Add cookies received in responses to the session handling cookie jar	添加响应中收到的cookies到会话处理cookie jar中
Add discovered content to suite site map	将发现的内容添加到Sitemap
Add entries here to override your computer's DNS resolution.	在此处添加以覆盖计算机的DNS名称解析。
Add form field completion rule	添加表单字段完成规则
Add from list ...	从列表中添加...
Add from list ... [Pro version only]	从列表中添加... [仅限专业版]
Add hostname resolution rule	添加主机名解析规则
Add links. Add item itself, same domain and URLs in suite scope.	添加链接，添加自己的网址，同一域名，套件范围。
Add match/replace rule	添加搜索/替换规则
Add payload processing rule	添加有效载荷处理规则
Add platform authentication credentials	添加平台身份验证凭据
Add prefix	添加前缀
Add prefix for in-scope URLs	添加范围内URL的前缀
Add prefix for out-of-scope URLs	为超出范围的 URL 添加前缀
Add random variations	添加随机变化
Add random variations to throttle	添加随机的变化到请求中(增加隐蔽性)
Add raw payload	添加原始payload
Add request header	添加请求标头
Add request interception rule	添加请求拦截规则
Add response interception rule	添加响应拦截规则
Add streaming URL	添加流式 URL
Add streaming URL prefix	添加流式 URL 前缀
Add suffix	添加后缀
Add the specified item	添加指定的项目
Add to scope	添加到范围
Add to site map	添加到站点地图
Add to task	添加到任务
Add to task: (.*)	添加到任务：$1
Add upstream proxy rule	添加上行代理规则
Add §	添加 §
Additional encrypted strings - optional	附加加密字符串-可选
Additional encrypted strings - optional \(([0-9]+)\)	附加加密字符串-可选($1)
Advisory	咨询
After recovering session:	会话恢复后：
After running the macro, invoke a Burp extension action handler:	执行宏后，执行Burp扩展操作处理程序：
Ajax request header manipulation \(DOM-based\)(\s+\[[0-9]+\])?	Ajax请求头操作（DOM基础）$1
Ajax request header manipulation \(reflected DOM-based\)(\s+\[[0-9]+\])?	Ajax请求头操作（反射DOM基础）$1
Ajax request header manipulation \(stored DOM-based\)(\s+\[[0-9]+\])?	Ajax请求头操作（累积类型DOM基础）$1
Alerts	警告
Target	目标
Alias	別名
All	全部
All bits failed the test. 	全部的bits都没有通过测试。
All bits passed the test. 	全部的bits都通过了测试。
All bits passed the test. Note that the FIPS specification for this test only records a fail if the longest run of bits is overly long. However, an overly short longest run of bits also indicates that the sample is not random. Therefore some bits may record a significance level that is below the FIPS pass level even though they do not strictly fail the FIPS test.	全部的bits都通过了测试。需要注意的是，如果最长的位序列太长，则此测试的FIPS规范将失败。 然而，最长的位序列太短也表明样本不是随机的。 因此，某些位可能低于FIPS通过级别，尽管它们不会通过严格的FIPS测试。
All interfaces	所有接口
All issues	所有问题
All items were successfully cleaned up.	所有项目均已成功删除。
All rows	所有行
All tests were successful. 	所有的测试都是成功的。
All tools:	所有工具:
Allow access without API key (using this option is not secure)	允许在没有API密钥的情况下访问（此选项不安全）
Allow renderer to make HTTP requests (for images, etc.)	允许渲染器发送HTTP请求（图像等）
Allow requests to web interface using fully-qualified DNS hostnames	在Web接口中允许完全限定的DNS主机名
Allow unsafe renegotiation (required for some client certificates)	允许不安全的重新协商（某些客户端证书需要）
Always	总是
Always disable	始终禁用
Always enable	始终启用
Always take the same action in future	从下一次开始执行相同的操作
An error occurred when recovering project data.	恢复项目数据时发生错误
An error occurred when starting a project with the selected options.	使用所选选项启动项目时发生错误。
An error occurred while attempting to process the activation response. Please check that you are using the latest JRE from Oracle.	处理激活响应时发生错误。请确保您使用的是Oracle最新的JRE。
An error occurred while attempting to verify your license key. Please check that you are using the latest Java Runtime Environment from Oracle, or try re-entering your license key.	验证许可证密钥时发生错误。请确认您使用的是Oracle的最新Java执行环境或重新输入许可证密钥。
An error occurred while loading the extension. Any output or error messages generated are shown below.	加载扩展程序时发生错误。生成的输出和错误显示在下面。
An error occurred: Input file is not in correct format	发生错误：输入文件的格式不正确
An error occurred: The input file is not in correct format	发生错误：输入文件的格式不正确
An update is available.	一个更新可用。
An update is available. Please select the build that you want to download.	一个更新可用。请选择您要下载的版本。
Analysis Options	分析选项
Analysis options	分析选项
Analyze and display AMF messages (use with caution)	分析并显示AMF消息（请谨慎使用）
Analyze now	执行分析
Analyze target	目标分析
Analyzing character set	分析字符集
Anomalies	异常
Answering "yes" will avoid accumulating project data for out-of-scope items.	如果选择“是”，则范围外的项目将不会累积在项目数据中。
Any header	任何头部
Any parameter	任何参数
Any status code with Location header	带有Location标头的任何状态代码
Append preprocessed payload	将预处理器有效载荷添加到最后
Append to base parameter value	添加到原始参数值
Application	应用
Application Login	应用登录
Application login	应用登录
April	4月
Are you sure you want to add this item to the site map?	您确定要将此项目添加到Sitemap吗？
Are you sure you want to cancel the download?	您确定要取消下载吗？
Are you sure you want to cancel the import?	您确定要取消导入吗？
Are you sure you want to cancel this macro?	您确定要取消此宏吗？
Are you sure you want to cancel this rule?	您确定要取消此规则吗？
Are you sure you want to cancel this streaming response?	您确定要取消流媒体响应吗？
Are you sure you want to cancel?	你想取消吗？
Are you sure you want to change options and re-run the comparison?	您确定要更改选项并重新执行比较吗？
Are you sure you want to clear all events?	您确定要清除所有活动吗？
Are you sure you want to clear queues?	您确定要清除队列吗？
Are you sure you want to clear the entire request template?	您确定要清除整个请求模板吗？
Are you sure you want to clear the history?	你确定要清除历史吗？
Are you sure you want to clear the list?	您确定要清除列表吗？
Are you sure you want to close the comparison?	你确定要关闭比较吗？
Are you sure you want to close the tracer?	你确定要关闭跟踪器吗？
Are you sure you want to close this Burp Collaborator client? Any further interactions from its payloads will be lost.	您确定要关闭Burp Collaborator客户端吗？来自该有效载荷的后续通信丢失。
Are you sure you want to close this window?	你确定要关闭这个窗口吗？
Are you sure you want to delete the selected item?	您确定要删除所选项吗？
Are you sure you want to delete the selected items?	您确定要删除所选项吗？
Are you sure you want to empty the cookie jar?	你确定要清空cookie jar吗？
Are you sure you want to exit the wizard?	您确定要退出向导吗？
Are you sure you want to exit this content discovery session?	您确定要结束此内容搜索会话吗？
Are you sure you want to exit?	你确定要退出吗？
Are you sure you want to listen on all interfaces?	你确定在所有接口上侦听吗？
Are you sure you want to proceed?	你确定要继续吗？
Are you sure you want to regenerate Burp's CA certificate?	你想重新生成Burp的CA证书吗？
Are you sure you want to remove this action?	您确定要删除此操作吗？
Are you sure you want to remove this certificate?	您确定要删除此证书吗？
Are you sure you want to remove this item?	您确定要删除此项吗？
Are you sure you want to remove this listener?	您确定要删除此侦听器吗？
Are you sure you want to remove this macro?	您确定要删除此宏吗？
Are you sure you want to remove this rule?	您确定要删除此规则吗？
Are you sure you want to restore default Burp Collaborator server options?	您确定要将Burp Collaborator服务器选项重置为默认值吗？
Are you sure you want to restore default Burp Extender options?	您确定要将Burp Extender选项重置为默认值吗？
Are you sure you want to restore default HTML rendering options?	您确定要将HTML呈现选项重置为默认值吗？
Are you sure you want to restore default HTTP message display options?	您确定要将HTTP消息显示选项重置为默认值吗？
Are you sure you want to restore default Java environment options?	您确定要将Java环境选项还原为默认值吗？
Are you sure you want to restore default Python environment options?	您确定要将Python环境选项重置为默认值吗？
Are you sure you want to restore default Ruby environment options?	您确定要将Ruby环境选项重置为默认值吗？
Are you sure you want to restore default SOCKS proxy options?	您确定要恢复默认的SOCKS代理选项吗？
Are you sure you want to restore default SSL negotiation options?	您确定要将SSL协商选项重置为默认值吗？
Are you sure you want to restore default SSL negotiation workarounds options?	SSL协商解决方法您确定要将选项重置为默认值吗？
Are you sure you want to restore default SSL passthrough options?	您确定要将SSL 穿透选项重置为默认值吗？
Are you sure you want to restore default active scanning areas options?	您确定要将活动扫描目标选项重置为默认值吗？
Are you sure you want to restore default active scanning engine options?	您确定要将活动扫描引擎选项重置为默认值吗？
Are you sure you want to restore default active scanning optimization options?	您确定要将活动扫描优化选项重置为默认值吗？
Are you sure you want to restore default application login options?	您确定要将应用程序登录选项重置为默认值吗？
Are you sure you want to restore default attack insertion points options?	您确定要将攻击插入点选项重置为默认值吗？
Are you sure you want to restore default attack results options?	您确定要将攻击结果选项重置为默认值吗？
Are you sure you want to restore default automatic project backup options?	您确定要将自动项目备份选项重置为默认值吗？
Are you sure you want to restore default character set options?	您确定要将字符集选项重置为默认值吗？
Are you sure you want to restore default client SSL certificates options?	您确定要将客户端SSL证书选项重置为默认值吗？
Are you sure you want to restore default cookie jar options?	您确定要将cookie jar选项重置为默认值吗？
Are you sure you want to restore default crawler options?	您确定要将抓取工具选项重置为默认值吗？
Are you sure you want to restore default extract grep options?	您确定要将提取的grep选项重置为默认值吗？
Are you sure you want to restore default form submission options?	您确定要将表单提交选项重置为默认值吗？
Are you sure you want to restore default hostname resolution options?	您确定要将主机名解析选项重置为默认值吗？
Are you sure you want to restore default hotkey options?	您确定要将热键选项重置为默认值吗？
Are you sure you want to restore default intercept WebSockets messages options?	您确定要将WebSocket消息的拦截选项重置为默认值吗？
Are you sure you want to restore default intercept client requests options?	您确定要将客户端请求的拦截选项重置为默认值吗？
Are you sure you want to restore default intercept server responses options?	您确定要将服务器响应拦截选项重置为默认值吗？
Are you sure you want to restore default live active scanning options?	您确定要将实时活动扫描选项重置为默认值吗？
Are you sure you want to restore default live capture options?	您确定要将实时捕捉选项重置为默认值吗？
Are you sure you want to restore default live passive scanning options?	您确定要将实时被动扫描选项重置为默认值吗？
Are you sure you want to restore default logging options?	您确定要将日志记录选项重置为默认值吗？
Are you sure you want to restore default macros options?	您确定要将宏选项重置为默认值吗？
Are you sure you want to restore default match and replace options?	您确定要将搜索和替换选项重置为默认值吗？
Are you sure you want to restore default match grep options?	您确定要将match grep选项重置为默认值吗？
Are you sure you want to restore default miscellaneous proxy options?	您确定要将其他代理选项还原为默认值吗？
Are you sure you want to restore default miscellaneous proxy settings options?	您确定要还原默认代理配置选项吗？
Are you sure you want to restore default out-of-scope requests options?	您确定要将范围外请求选项重置为默认值吗？
Are you sure you want to restore default passive scanning areas options?	您确定要将被动扫描目标选项重置为默认值吗？
Are you sure you want to restore default passive spidering options?	您确定要将被动拼接选项重置为默认值吗？
Are you sure you want to restore default performance feedback options?	您确定要将性能反馈选项重置为默认值吗？
Are you sure you want to restore default platform authentication options?	您确定要将平台身份验证选项重置为默认值吗？
Are you sure you want to restore default proxy history logging options?	您确定要将代理历史记录日志选项恢复为默认值吗？
Are you sure you want to restore default proxy listeners options?	您确定要将代理侦听器选项还原为默认值吗？
Are you sure you want to restore default redirections options?	您确定要将重定向选项重置为默认值吗？
Are you sure you want to restore default request engine options?	您确定要将请求引擎选项重置为默认值吗？
Are you sure you want to restore default request headers options?	您确定要将请求标头选项重置为默认值吗？
Are you sure you want to restore default response modification options?	您确定要将响应操作选项重置为默认值吗？
Are you sure you want to restore default rest api options?	您确定要将REST API选项重置为默认值吗？
Are you sure you want to restore default scan issues options?	您确定要将扫描项目选项重置为默认值吗？
Are you sure you want to restore default scheduled tasks options?	您确定要将计划任务选项还原为默认值吗？
Are you sure you want to restore default server SSL certificates options?	您确定要将服务器SSL证书选项重置为默认值吗？
Are you sure you want to restore default session handling rules options?	您确定要将会话处理规则选项重置为默认值吗？
Are you sure you want to restore default spider engine options?	您确定要将Spider引擎选项重置为默认值吗？
Are you sure you want to restore default spider scope options?	您确定要将Spider范围选项重置为默认值吗？
Are you sure you want to restore default static code analysis options?	您确定要将静态代码分析选项重置为默认值吗？
Are you sure you want to restore default status 100 responses options?	状态100响应您确定要将选项重置为默认值吗？
Are you sure you want to restore default streaming responses options?	您确定要将流式响应选项重置为默认值吗？
Are you sure you want to restore default target scope options?	您确定要将目标范围选项重置为默认值吗？
Are you sure you want to restore default temporary files location options?	您确定要将临时文件位置选项重置为默认值吗？
Are you sure you want to restore default timeouts options?	您确定要将超时选项重置为默认值吗？
Are you sure you want to restore default token analysis options?	您确定要将令牌分析选项重置为默认值吗？
Are you sure you want to restore default token handling options?	您确定要将令牌处理选项重置为默认值吗？
Are you sure you want to restore default upstream proxy servers options?	您确定要还原为默认代理服务器选项吗？
Are you sure you want to restore default user interface options?	您确定要将用户界面选项重置为默认值吗？
Are you sure you want to restore defaults for Project options?	您确定要恢复为项目选项的默认值吗？
Are you sure you want to restore defaults for Proxy?	您确定要将代理选项重置为默认值吗？
Are you sure you want to restore defaults for Repeater?	您确定要将重放器选项恢复为默认值吗？
Are you sure you want to restore defaults for Scanner?	您确定要将扫描器选项重置为默认值吗？
Are you sure you want to restore defaults for Sequencer?	您确定要将定序器选项重置为默认值吗？
Are you sure you want to restore defaults for Spider?	您确定要将Spider的选项重置为默认值吗？
Are you sure you want to restore defaults for Target?	您确定要将目标选项重置为默认值吗？
Are you sure you want to restore defaults for all project options?	您确定要将所有项目选项重置为默认值吗？
Are you sure you want to restore defaults for user options?	您确定要将用户选项重置为默认值吗？
Are you sure you want to retest the macro?	你确定要重新测试宏吗？
Are you sure you want to shut down Burp and launch the downloaded file?	关闭Burp并启动下载的文件？
Are you sure you want to shut down Burp and run the new version?	你确定要关闭Burp并开始新版本吗？
Are you sure you want to stop?	你确定要停下来吗？
At least one URL to scan must be specified.	请指定至少一个要扫描的URL。
At least one item to scan must be specified.	请指定至少一个要扫描的项目。
At least one kind of analysis must be selected	必须至少选择一种类型的分析。
Attack	攻击
Attack Insertion Points	攻击插入点
Attack Results	攻击结果
Attack Target	攻击目标
Attack configuration	攻击配置
Attack type:	攻击类型:
Attempt data recovery	尝试数据恢复
Attempt to self-register a user	尝试自行注册用户
Audit Optimization	审计优化
Audit accuracy:	审计准确率:
Audit again	再次审核
Audit finished.	审计已结束.
Audit items	审核项目
Audit items documentation	审计项目文档
Audit selected items	选择审计项目
Audit speed:	审计速度:
Auditing	审计
Auditing. Estimating time remaining...	审计中. 剩余时间估算中....
August	8月
Auth type	验证类型
Authenticated crawl (random). Estimating time remaining...	身份验证(随机).评估剩余时间....
Authentication Required	需要验证
Authentication required	需要验证
Authentication type:	验证类型：
Author:	作者:
Auto analyze	自动解析
Auto §	自动§
Auto-detect	自动检测
Auto-modified message	自动更改消息
Auto-modified request	自动更改请求
Auto-modified response	自动更改响应
Auto-scroll to match when text changes	在文本更改时自动滚动到匹配的位置
Auto-select based on request features	从请求功能中自动选择
Automatic BApp updates	自动BApp更新
Automatic Project Backup	自动项目备份
Automatic Project Backup [disk projects only]	自动项目备份[仅限磁盘项目]
Automatic backup failed	自动备份失败
Automatic payload positions	自动负载位置
Automatic project backup	自动项目备份
Automatic project backup saves a copy of the Burp project file periodically in the background.	Project Auto Backup会定期在后台保存Burp项目文件的副本。
Automatically add entries on client SSL negotiation failure	客户端会自动添加SSL连接失败的条目
Automatically back up the project every	自动项目备份间隔
Automatically fix missing or superfluous new lines at end of request	自动补偿上次请求中缺少或过多的换行符
Automatically locate library	从本地库自动搜索
Automatically maintain session (only applies to crawl-driven audits)	自动维护会话（仅适用于爬虫-驱动的审计）
Automatically reload extensions on startup	在启动时自动重新加载扩展
Automatically scan the following targets as you browse. Active scan checks send various malicious requests designed to identify common vulnerabilities. Use with caution.	浏览以下对象时，扫描将自动执行。主动扫描检查会发送各种恶意请求，并尝试发现常见漏洞。请谨慎使用。
Automatically scan the following targets as you browse. Passive scan checks analyze your existing traffic for evidence of vulnerabilities, and do not send any new requests to the target.	浏览以下对象时，扫描将自动执行。被动扫描检查将现有流量分析为漏洞跟踪，不会向目标发送新请求。
Automatically select compatible SSL parameters on negotiation failure	协商失败时自动选择兼容的SSL参数
Automatically set a payload at each URL, cookie and body parameter	自动将有效载荷设置为每个URL，cookie，body参数
Automatically start tasks	自动启动任务
Automatically submit these credentials:	自动发送此凭据：
Automatically submit using the following rules to assign text field values:	根据以下规则自动发送文本字段值：
Automatically update Content-Length header when the request is edited	编辑请求时自动更新Content-Length标头
Automatically update Content-Length header when the response is edited	编辑响应时自动更新Content-Length标头
Automatically update installed BApps on startup	在启动时自动更新已安装的BApp
BApp verification failed - the BApp may be unsigned or may have been tampered with.	BApp验证失败 -  BApp可能未签名或可能未被篡改。
Back	返回
Backup Interval	备份间隔
Backup file: 	备份文件：
Base request	原始请求
Base response	原始响应
Base string:	元文字列:
Base value of payload position	有效载荷位置原始值
Base value:	原值：
Base64-decode	Base64解码
Base64-decode before analyzing	解析前的Base64解码
Base64-encode	Base64编码
Base64-encode requests and responses	Base64编码的请求和响应
Base:	基地：
Battering ram	破城槌(Battering ram)
Billing	计费
Bind to address:	绑定地址：
Bind to port:	绑定端口：
Bit Compression Analysis - Compression Ratios	Bit压缩分析 - 压缩比
Bit Compression Analysis - Significance Levels	Bit压缩分析 - 重要性级别
Bit Correlation Analysis - Significance Levels	Bit相关分析 - 重要性级别
Bit conversion	Bit转换
Bit flipper	Bit 翻转(Bit flipper)
Bit-level analysis	Bit-级别分析
Blind	盲注
Block size (usually 8 or 16):	块大小（通常为8或16）：
Body	主体
Body encoding:	主体编码：
Body parameter	主体参数
Body parameter values	主体参数值
Body to URL	来自主体的网址
Body to cookie	来自主体的cookie
Boolean condition checks	布尔类型条件检查
Boolean conditions	布尔类型条件
Boolean operator:	布尔类型条件:
Breadth-first hop limit:	广度优先跳跃限制：
Brute forcer	暴力破解(Brute forcer)
Building GUI	构建GUI
Builds:	建设：
Built-in	内置
Built-in long directory list	长内置目录名称列表
Built-in long file list	内置长文件名列表
Built-in short directory list	短内置目录名称列表
Built-in short file list	内置短文件名列表
Burp Clickbandit is a tool for generating clickjacking attacks. When you have found a web page that may be vulnerable to clickjacking, you can use Burp Clickbandit to create an attack, and confirm that the vulnerability can be successfully exploited.	Burp Clickbandit是一种用于产生点击顶升攻击的工具。如果您发现具有点击起始漏洞的网页，则可以使用Burp Clickbandit创建攻击并查看是否可以利用此漏洞。
Burp Clickbandit runs in your browser using JavaScript. It works on all modern browsers except for Microsoft IE and Edge. To run Burp Clickbandit, use the following steps:	Burp Clickbandit使用JavaScript在浏览器中运行。它适用于除Microsoft IE和Edge之外的所有最新浏览器。要运行Burp Clickbandit，请使用以下过程：
Burp Collaborator Health Check	Burp Collaborator健康检查
Burp Collaborator Server	Burp Collaborator服务器
Burp Collaborator client	Burp Collaborator客户端
Burp Collaborator is an external service that Burp can use to help discover many kinds of vulnerabilities. You can use the default Collaborator server provided by PortSwigger, or deploy your own instance. You should read the full documentation for this feature and decide which option is most appropriate for you.	Burp Collaborator是一项外部服务，可帮助Burp发现许多漏洞。您可以部署和使用PortSwigger或您自己的实例提供的默认Collaborator服务器。请阅读有关此功能的所有文件，并做出最有效的选择。
Burp Extender APIs	Burp扩展API
Burp Extensions	Burp扩展
Burp Infiltrator [Pro version only]	Burp Infiltrator [仅限专业版]
Burp Infiltrator currently supports applications written in Java or other JVM-based languages such as Groovy. Java versions from 4 and upwards are supported.	Burp Infiltrator目前支持用Java或其他基于JVM的语言（如Groovy）开发的应用程序。它支持Java版本4或更高版本。
Burp Infiltrator is a tool for instrumenting target web applications in order to facilitate testing using Burp Scanner. Burp Infiltrator modifies the target application so that Burp can detect cases where its input is passed to potentially unsafe APIs on the server side.	Burp Infiltrator是一个工具，用于将目标Web应用程序转换为工具，以便使用Burp Scanner进行测试。更改目标应用程序，以便Burp可以检测Burp的输入是否已通过潜在危险的API。
Burp Infiltrator was saved successfully as: burp_infiltrator_java.jar	Burp Infiltrator已成功保存：burp_infiltrator_java.jar
Burp Proxy uses listeners to receive incoming HTTP requests from your browser. You will need to configure your browser to use one of the listeners as its proxy server.	Burp 代理使用侦听器接收来自浏览器的HTTP请求。您需要在浏览器中将其中一个侦听器配置为代理服务器。
Burp Repeater documentation	Burp 重放器文档
Burp Repeater help	Burp 重放器帮助
Burp Scanner reporting wizard	Burp扫描仪报告向导
Burp Spider - Submit Form	Burp Spider  - 提交表格
Burp Spider needs your guidance to submit a login form. Please choose the value of each form field which should be used when submitting the form, and whether Burp should iterate submission of multi-value fields. You can control how Burp handles forms in the Spider options tab.	Burp Spider需要您的输入才能发送登录表单。请选择要用于传输的每个表单字段的值以及是否重复具有多个值的字段。您可以在“蜘蛛”选项卡上控制表单的处理方式。
Burp Spider needs your guidance to submit a login form. Please choose the value of each form field which should be used when submitting the form. You can control how Burp handles forms in the Spider options tab.	Burp Spider需要您的输入才能发送登录表单。请选择要用于发送的每个表单域的值。您可以在“蜘蛛选项”选项卡上控制表单的处理方式。
Burp Suite Community Edition	Burp Suite社区版
Burp Suite Documentation	Burp Suite文档
Burp Suite Professional	Burp Suite Professional
Burp Suite diagnostics	Burp Suite审计
Burp Suite documentation	Burp Suite文档
Burp Suite search	Burp Suite搜索
Burp has not been fully tested on this platform and you may experience problems.	Burp还未在此平台上进行完整的测试，可能会遇到问题。
Burp is up to date.	Burp是最新的。
Burp license key	Burp许可证密钥
Burp maintains a cookie jar that stores all of the cookies issued by visited web sites. Session handling rules can use and update these cookies to maintain valid sessions with applications that are being tested. You can use the settings below to control how Burp automatically updates the cookie jar based on traffic from particular tools.	我们将访问过的网站发布的所有cookie保存在cookie jar中。会话处理规则可以使用和更新这些cookie，以保持您正在测试的应用程序的有效会话。以下设置控制如何根据特定工具的流量自动更新Cookie jar。
Burp program executable	Burp执行程序
Burp will attempt to repair the project file. This will create a new project file that can be opened safely, and will preserve as much data as possible from the original file.	Burp将尝试修复项目文件。这将创建一个可以安全打开的新项目文件，并从原始文件中存储尽可能多的数据。
Burp will now attempt to contact the license server and activate your license. This will require Internet access. If you access the Internet via a web proxy server, please enter the details below.	我将连接到许可证服务器并尝试许可证身份验证。这需要互联网访问。要通过代理服务器访问Internet，请在下面输入详细信息。
Byte compare	字节比较
Bytes	字节
Bytes transferred:	传输的字节数：
CA Certificate	CA证书
CGI scripts	CGI脚本
CSRF PoC generator	CSRF PoC发电机
CSRF PoC generator documentation	CSRF PoC生成器文档
CSRF technique:	CSRF技术：
Caching	高速缓存
Cancel	取消
Cannot remove macro	无法删除宏
Cannot remove macros	无法删除宏
Capturing:	捕获：
Case modification	大小写修改(Case modification)
Case modifications	大小写修改
Case sensitive	区分大写和小写字母
Case sensitive match	区分大写和小写字母
Case sensitivity:	信件案例：
Case-sensitivity:	信件案例：
Certain	已确定
Certificate	证书
Certificate and private key in DER format	DER格式的证书和密钥
Certificate file:	证书文件：
Certificate in DER format	DER格式的证书
Certificate type:	证书类型：
Change body encoding	改变主体编码
Change font ...	改变字体......
Change options	期权变更
Change parameter locations (causes many more scan requests):	更改参数位置（将发生大扫描请求）：
Change request method	变更请求方法
Change the font used to display HTTP messages	更改用于显示HTTP消息的字体
Change...	改变......
Changes will take effect when Burp is restarted.	更改将在重新启动后生效。
Character Count Analysis - Significance Levels	文字数解析 - 重要性级别
Character Set	字符集
Character Sets	字符集
Character Transition Analysis - Significance Levels	文字迁移解析 - 重要性级别
Character blocks	字符块(Character blocks)
Character frobber	字符frobber(Character frobber)
Character set	字符集
Character set:	字符集：
Character substitution	字符置换(Character substitution)
Character substitutions	字符置换
Character-level analysis	字符等级分析
Check for updates	更新检查
Check session is valid	检查会话的有效性
Checking for available installers	检查可用的安装程序
Checking for updates	检查更新
Choose a file to export the CA certificate.	请选择要导出CA证书的文件。
Choose a file to export the certificate and private key, and a password to use for the keystore. 	选择要导出证书和密钥的文件，然后输入要设置为密钥库的密码。
Choose a file to export the private key. 	请选择要导出私钥的文件。
Choose a file to paste from	请选择粘贴源文件
Choose a file to save the configuration to	请选择一个文件以保存设置
Choose a file to save to	请选择要保存的文件
Choose a preset scheme	选择预定义格式
Choose an attack to open	请选择要打开的攻击
Choose an empty directory to save responses to	请选择一个空目录以保存响应。
Choose file...	文件选择......
Choose folder ...	选择文件夹...
Choose predefined task...	选择预定义任务......
Choose the folder where temporary files will be saved	选择存储临时文件的文件夹
Choose the format for the report.	请选择报告格式。
Choose the tools whose data you want to be included in the new project file and whether you only want to save in-scope items.	请选择要包含在新项目文件中的工具数据以及是否仅保存范围中的项目。
Choose the tools whose data you want to import from the project file.	请选择一个工具从项目文件中导入数据。
Choose this option if you plan to load the state file later and continue testing, or pass it on to someone else who will take over your testing. You should be aware that if any testing is continued using multiple instances of Burp, then some Collaborator-based issues may be missed or incorrectly reported.	如果您想稍后加载此状态文件并继续测试或将其传递给其他人接管测试，请选择此选项。如果继续使用多个Burp实例进行测试，可能会错过或报告基于Collaborator的问题。
Choose this option if you plan to pass the project file on to someone else, but you do not want them to be able to receive details of any ongoing Burp Collaborator interactions that are associated with your testing. Any new scanning that is performed by the other user will use a different unique identifier, to avoid any interference with other instances of Burp.	如果您计划将项目文件传递给其他人但不想继续接收与测试相关联的Collaborator的详细信息，请选择此选项。要执行的新扫描使用不同的唯一标识符以避免干扰其他Burp实例。
Choose this option if you plan to pass the state file on to someone else, but you do not want them to be able to receive details of any ongoing Burp Collaborator interactions that are associated with your testing. Any new scanning that is performed by the other user will use a different unique identifier, to avoid any interference with other instances of Burp.	如果您计划将状态文件传递给其他人但不想继续接收与测试相关联的Collaborator的通信详细信息，请选择此选项。要执行的新扫描使用不同的唯一标识符以避免干扰其他Burp实例。
Choose this option if you plan to use the project file later and continue testing, or pass it on to someone else who will take over your testing. You should be aware that if any testing is continued using multiple instances of Burp, then some Collaborator-based issues may be missed or incorrectly reported.	如果您想稍后加载此项目文件并继续测试或将其传递给其他人接管测试，请选择此选项。如果继续使用多个Burp实例进行测试，可能会错过或报告基于Collaborator的问题。
Choose which tools you want to restore the configuration of.	请选择一种工具来恢复设置。
Choose which tools you want to restore the state of.	请选择恢复状态的工具。
Choose which tools you want to save the configuration of.	请选择一种工具来保存设置。
Choose which tools you want to save the state of. Note that it is not necessary to save the Spider state. The Spider request queues will be automatically rebuilt based on a restored target site map and scope configuration.	请选择要保存在该状态的工具。请注意，您无需保存Spider的状态。 Spider的请求队列将从还原的目标站点地图和范围设置中自动重建。
Choosing this option means that your instance of Burp will not receive details of any ongoing Burp Collaborator interactions that were associated with the project. Any new scanning that you perform will use a different unique identifier, to avoid any interference with other instances of Burp.	如果选择此选项，则此Burp实例将不会收到与正在进行的与项目关联的Burp Collaborator进行通信的详细信息。要执行的新扫描使用不同的唯一标识符以避免干扰其他Burp实例。
Choosing this option means that your instance of Burp will receive details of any ongoing Burp Collaborator interactions that are associated with the project. If any other instance of Burp is also receiving interaction details for the same project, then some Collaborator-based issues may be missed or incorrectly reported.	如果选择此选项，此Burp实例将接收与正在进行的与项目关联的Burp Collaborator的通信的详细信息。如果其他Burp实例也接收到同一项目的通信详细信息，则可能会错过或报告基于协作者的问题。
Cipher	Cipher加密
Clean Burp from computer	从计算机中删除Burp
Clear	清除
Clear all	清除所有
Clear all items and separators from all positions	从所有位置清除项目和分隔符
Clear all payload markers	清除所有有效载荷标记
Clear all text and payload markers	清除所有文本和有效载荷标记
Clear event log	清除事件日志
Clear histories	清除的历史
Clear history	清除的历史
Clear queues	清除队列
Clear the contents of the viewer	清除查看器内容
Clear §	§清除
Click "Copy to clipboard" to generate Burp Collaborator payloads that you can use in your own testing. Any interactions that result from using the payloads will appear below.	通过单击“复制到剪贴板”，您可以生成可在您自己的测试中使用的Burp Collaborator的有效载荷。下面显示使用有效载荷的结果的通信。
Click to modify	点击编辑
Client SSL Certificate	客户端SSL证书
Client SSL Certificates	客户端SSL证书
Client-side	客户端
Close	关闭
Close wizard	关闭向导
Cluster bomb	集束炸弹(Clusterbomb)
Collapse	折叠
Collapse branch	折叠分支
Columns	列
Comment	评论
Comment this item	评论这个项目
Comment:	编辑点评：
Comments	评论
Comments:	编辑点评：
Compare ...	比较 ...
Compare responses	响应比较
Compare site map	Sitemap比较
Compare site maps	Sitemaps比较
Compression	压缩
Computing differences	计算差异
Concatenate to single file	连接到单个文件
Concurrent request limit:	同时请求限制：
Condition	条件
Confidence	可靠性
Config	设定
Configuration File Error	配置文件错误
Configuration exported successfully.	成功导出设置。
Configuration imported successfully.	成功导入设置。
Configuration library	配置库
Configuration name:	设定名:
Configuration:	设定:
Configure	设定
Configure Macro Item	宏项目设置
Configure REST API URL	REST API URL设置
Configure hotkeys	配置热键
Configure how cookies and request parameters are handled for this macro item.	设置如何在此宏项中处理cookie和请求参数。
Configure item	项目设置
Configure predefined payload lists	编辑预定义的有效载荷
Configure target details	设定目标详情
Configure the details of the custom parameter location. You need to specify the name that is used for this parameter in subsequent macro requests, and the location within this response from which the parameter's value should be derived.	设置自定义参数位置的详细信息在后续宏请求中使用此参数时，必须指定名称，并将要提取的响应中的位置指定为参数值。
Configure the details of the target for the attack.	请设置攻击目标的详细信息。
Configure the location of the items that Burp Intruder should use for its predefined payload lists.	请设置Burp 攻击器使用的预定义有效载荷列表的位置
Configure the options below to determine how Burp handles certain features of responses when performing comparisons.	执行比较时，请设置以下选项，以了解Burp如何处理响应的每个功能。
Configure the positions where payloads will be inserted into the base request. The attack type determines the way in which payloads are assigned to payload positions - see help for full details.	设置在基本请求中插入有效载荷的位置。攻击类型指定如何将有效载荷分配给有效载荷位置。 - 有关详细信息，请参阅帮助。
Configure the selected item	设置所选项目
Configure the settings for the custom token location	令牌位置的自定义设置
Configure the sources Burp should use for generating filenames to test.	设置文件名测试生成的源。
Confirm	确认
Connections	连接
Consolidate frequently occurring passive issues	整合频繁发生的被动问题
Consolidate items	整合项目......
Consolidate items...	整合项目......
Construct string	构造字符串
Construct string in JavaScript	构造JavaScript字符串
Construct string in Microsoft SQL Server	构造Microsoft SQL Server字符串
Construct string in MySQL	构造MySQL字符串
Construct string in Oracle	构造Oracle字符串
Contacting License Server	连接到许可证服务器
Contains parameters	包括参数
Content type header	内容类型头部
Contents	内容
Continue	下一个
Continue indefinitely	无限期地重复
Control	控制
Convert HTTPS links to HTTP	将HTTPS链接转换为HTTP
Convert selection	转换选择
Convert to JavaScript constructed string	转换为JavaScript语法字符串
Convert to Microsoft SQL Server constructed string	转换为Microsoft SQL Server语法字符串
Convert to MySQL constructed string	转换为MySQL语法字符串
Convert to Oracle constructed string	转换为Oracle语法字符串
Cookie handling	Cookie处理
Cookie jar viewer	Cookie jar查看器
Cookie name	cookie名
Cookie parameter values	Cookie参数值
Cookie to URL	来自cookie的URL
Cookie to body	来自主体的cookie
Cookie value	Cookie值
Cookie:	Cookie：
Cookies	Cookies
Cookies received	收到的cookie
Copy	复制
Copy ...	复制......
Copy Clickbandit to clipboard	将Clickbandit复制到剪贴板
Copy HTML	复制HTML
Copy URL	复制网址
Copy URLs	复制网址
Copy URLs in this branch	复制此分支的URL
Copy URLs in this host	将URL复制到此主机
Copy as curl command	复制curl命令
Copy attack config	复制攻击配置
Copy configuration from first tab	从第一个选项卡复制设置
Copy configuration from last tab	从上一个标签复制设置
Copy content from suite site map	从Sitemap复制内容
Copy details	复制细节
Copy from position:	来源位置：
Copy key to clipboard	将密钥复制到剪贴板
Copy link	复制链接
Copy links	复制链接
Copy links in selected items	复制所选项目的链接
Copy links in selection	复制所选链接
Copy links in this branch	复制此分支的链接
Copy links in this host	将此链接复制到此主机
Copy other payload	复制其他载荷(Copy other payload)
Copy project	项目复制
Copy request	复制请求
Copy selected URLs	复制所选的URL
Copy to clipboard	复制到剪贴板
Copy to file	复制到文件
Copy tokens	复制令牌
Correlation	关联
Count	计数
Crawl	爬行
Crawl Limits	爬行限制
Crawl Optimization	爬行优化
Crawl and audit	爬行和审计
Crawl finished	爬行完成
Crawl finished.	抓取完成。
Crawl strategy tuning	调整爬行策略
Crawl strategy:	爬行策略：
Crawler Settings	爬行设置
Crawling	爬行
Crawling modern applications is sometimes an open-ended exercise, due to the amount of stateful functionality, volatile content, and unbounded navigation. Burp's crawler uses various techniques to maximise discovery of unique content early in the crawl. These settings let you impose a limit on the extent of the crawl, as it reaches the point of diminishing returns. You can leave any crawl limit setting blank to disable it.	由于有状态功能，不稳定的内容和无限制的导航，最新应用程序的爬行可能无止境。 Burp的爬虫使用各种技术尝试在最早的爬行时发现独特的内容。使用这些设置，爬行范围有限。将爬行限制留空以禁用它。
Create a new rule	创建新规则
Create new resource pool	创建一个新的资源池
Create new task	创建一个新任务
Create new tasks paused	创建暂停的任务
Create new tasks running	从任务创建开始
Critical	紧急
Cross-domain XHR (modern browsers only)	跨域XHR（仅限最新浏览器）
Current Action	当前动作
Current auditing configuration	当前的审计设置
Current live passive crawling configuration	当前的实时被动爬行设置
Current project file selected	已选择当前项目文件
Custom	自定义
Custom directory list:	自定义目录列表：
Custom file list:	自定义文件列表：
Custom iterator	自定义迭代器(Custom iterator)
Custom location:	自定义位置：
Custom parameter locations in response	响应中的自定义参数位置
Custom scope	自定义范围
Custom scope: Pasted value is not a valid URL	自定义范围：粘贴的值不是有效的URL
Custom:	自定义：
Cut	切割
Dashboard	仪表盘
Data	数据
Dates	日期(Dates)
Day rate:	日费率：
Days	日
Debug	调试
Debug ID:	调试ID：
December	12月
Decode as ...	解码......
Decode as ASCII hex	解码为ASCII十六进制
Deduplication	去重
Default configuration	默认设置
Default to the above in future	在下次之后将其设为默认值
Default to this option in future	下次之后将此选项设为默认选项
Define Custom Parameter	自定义参数定义
Define behavior dependent on session validity:	依赖于会话有效性的行为定义：
Define custom token location	令牌位置的自定义定义
Define extract grep from response	从响应中定义提取的grep
Define extract grep item	提取的grep项的定义
Define start and end	定义开始和结束
Define the URLs to scan. Burp will begin crawling from these URLs, and by default will include everything beneath the specified URLs' folders.	请定义要扫描的URL。 Burp开始从这些URL进行爬行，默认情况下它包含指定URL文件夹下的所有内容。
Define the in-scope targets for your current work. This configuration affects the behavior of tools throughout the suite. The easiest way to configure scope is to browse to your target and use the context menus in the site map to include or exclude URL paths.	在当前工作的范围内定义目标。此设置会影响整个工具的操作。如果您在浏览器中浏览目标并在Sitemap上下文菜单中包含或排除URL路径，则范围设置很容易。
Define the location of the item to be extracted. Selecting the item in the response panel will create a suitable configuration automatically. You can also modify the configuration manually to ensure it works effectively.	定义要提取的项目的位置。在响应面板中选择项目时，将自动创建相应的设置。您也可以手动更改设置以有效工作。
Define the location of the parameter value. Selecting the item in the response panel will create a suitable configuration automatically. You can also modify the configuration manually to ensure it works effectively.	定义参数值的位置。在响应面板中选择项目时，将自动创建相应的设置。您也可以手动更改设置以有效工作。
Define the location of the token within the response. Selecting the item in the response panel will create a suitable configuration automatically. You can also modify the configuration manually to ensure it works effectively.	在响应中定义令牌的位置。在响应面板中选择项目时，将自动创建相应的设置。您也可以手动更改设置以有效工作。
Define the start directory for the content discovery session, and whether files or directories should be targeted.	定义目录以启动内容发现会话和目标文件或目录。
Define which items are processed by the live scan, based on their URL.	根据URL，请定义要在实时扫描中处理的项目。
Delay between requests	请求之间的延迟
Delay between requests:	请求之间的延迟：
Delete	删除
Delete backup file on clean shutdown of Burp	当Burp正常完成时删除备份文件
Delete branch	删除分支
Delete byte	删除字节
Delete bytes ...	删除多个字节......
Delete cells	删除单元格
Delete host	删除主机
Delete issue	删除问题
Delete issues	删除问题
Delete issues for selected branches	删除所选分支的问题
Delete issues for this branch	删除此分支问题
Delete issues for this host	删除此主机问题
Delete item	删除项目
Delete old temporary files?	您确定要删除旧的临时文件吗？
Delete selected issues	删除所选问题
Delete selected items	删除所选项目
Deleting Burp executable.	删除Burp可执行程序。
Deleting Burp license key.	删除许可证密钥。
Deleting license key.	删除许可证密钥。
Deleting saved preferences.	删除已保存的设置。
Deleting temporary files.	删除临时文件。
Delimiter:	分隔符：
Derivations based on discovered items	根据检测到的项目导出
Derived parameters	派生参数
Description	描述
Description:	描述:
Destination host	目标主机
Destination host is not valid	目标主机无效
Destination host, may include wildcards	目标主机，可能包含通配符
Destination host:	目标主机：
Detail	详细
Detailed scope configuration	详细的范围设置
Details	详细
Detect custom "not found" responses	检测自定义的“未找到”响应
Detection methods	检测方法
Diagnostics	诊断
Diff count	差异数量
Direction	方向
Directories - long	目录 - 长
Directories - short	目录 - 简短
Directories / files . extensions	目录 / 文件 扩展名
Directories only	仅限目录
Directory:	目录：
Disable Java SNI extension (requires restart)	禁用Java SNI扩展（需要重新启动）
Disable SSL session resume	禁用SSL会话恢复
Disable extensions	禁用扩展
Disable web interface at http://burp	禁用http：// burp的Web界面
Discover content	内容发现
Discover:	发现:
Discovery Engine	发现引擎
Discovery Session Status	发现会话状态
Display	显示
Display as raw bytes	显示为原始字节
Do DNS lookups over SOCKS proxy	执行SOCKS代理上的DNS搜索
Do a passive scan	执行被动扫描
Do an active scan	执行主动扫描
Do illegal UTF-8	执行无效的UTF-8
Do illegal hex	执行无效的hex
Do intercept	执行拦截
Do not include Burp Collaborator identifier in the project file	不在项目文件中包含Burp Collaborator的标识符
Do not include Burp Collaborator identifier in the state file	不在状态文件中包含Burp Collaborator的标识符
Do not include requests	不包括请求
Do not include responses	不包括响应
Do not save	不保存
Do not take full ownership of the project	不获得项目的完整所有权
Do nothing	什么都不做
Do platform authentication	执行平台验证
Do you wish to continue?	你想继续吗？
Does not contain parameters	不包含参数
Does not match	不匹配
Doing FIPS long run test	正在进行FIPS最长运行测试
Doing FIPS monobit test	正在进行FIPS一维频率测试
Doing FIPS poker test	正在进行FIPS扑克验证
Doing FIPS runs test	正在进行FIPS连续测试
Doing bit compression test	正在进行bit压缩测试
Doing bit correlation test	正在进行bit相关测试
Doing character set tests	正在进行字符集测试
Doing spectral tests	正在进行频谱测试
Domain	域
Domain hostname	域名主机名
Domain hostname:	域名主机名：
Domain name	域名
Domain name resolution:	域名解析：
Domain:	域：
Don't ask again for this server	不再次请求此服务器
Don't compare non-text content	不比较非文本内容
Don't intercept requests	不拦截请求
Don't intercept responses	不拦截响应
Don't perform static code analysis	不执行静态代码分析
Don't restore	不进行恢复
Don't scan	不执行扫描
Don't send items to Proxy history or live tasks	不将项目发送到代理历史记录或实时任务
Don't send items to Proxy history or live tasks, if out of scope	如果超出范围，不将项目发送到代理历史记录或实时任务
Don't submit forms	不要提交表格
Don't submit login forms	不要发送登录表单
Don't use Burp Collaborator	不要使用Burp Collaborator
Done	完成
Down	下
Download	下载
Download failed.	下载失败。
Download other installers	下载其他安装程序
Downloading update	下载更新
Drop all out-of-scope requests	销毁范围之外的所有请求
Duplicate	重复
Duplicate configuration	重复设置
Duplicate hotkeys are configured	重复热键设置
Duplicate the selected item	复制所选项目
Duplicate the selected macro	复制选定的宏
Duplicate the selected rule	复制所选规则
Dynamic URLs	动态URL
Dynamic analysis	动态分析
Dynamic update	动态更新
ECB block shuffler	ECB加密块洗牌(ECB block shuffler)
Each Burp project has a unique identifier that is used to track any Burp Collaborator interactions that are associated with the project. You need to decide whether to include this identifier in your new project file.	每个Burp项目都有一个唯一的标识符，用于标识与项目相关的Burp Collaborator的通信。您需要决定是否将此标识符保存在新项目文件中。
Each Burp project has a unique identifier that is used to track any Burp Collaborator interactions that are associated with the project. You need to decide whether to save this identifier in your state file.	每个Burp项目都有一个唯一的标识符，用于标识与项目相关的Burp Collaborator的通信。有必要决定是否将此标识符保存在状态文件中。
Each installation of Burp generates its own CA certificate that Proxy listeners can use when negotiating SSL connections. You can import or export this certificate for use in other tools or another installation of Burp.	每次安装Burp时，它都会生成自己的CA证书，并在代理侦听器建立SSL连接时使用。此证书可以导入和导出，并可以与其他工具或其他计算机上安装的Burp一起使用。
Edit	编辑
Edit "skip parameter" rule	编辑“跳过参数”规则
Edit API key	编辑API密钥
Edit Login Credentials	编辑登录凭据
Edit SSL passthrough target	编辑SSL穿透目标
Edit URL to exclude from scope	编辑要从范围中排除的URL
Edit URL to include in scope	编辑要包含在范围中的URL
Edit audit scan	编辑审计扫描
Edit auditing configuration	编辑审计设置
Edit cookie	编辑Cookie
Edit crawl and audit scan	编辑爬行和审计扫描
Edit crawling configuration	编辑抓取设置
Edit detection methods	编辑检测方法
Edit form field completion rule	编辑表单字段完成规则
Edit hostname resolution rule	编辑主机名解析规则
Edit hotkeys	编辑热键
Edit list	编辑列表
Edit live audit task	编辑实时审计任务
Edit live passive crawl task	编辑实时被动爬行任务
Edit live passive crawling configuration	编辑被动爬行配置
Edit match/replace rule	编辑搜索/替换规则
Edit payload processing rule	编辑有效载荷处理规则
Edit platform authentication credentials	编辑平台身份验证凭据
Edit prefix for in-scope URLs	编辑范围内URL的前缀
Edit prefix for out-of-scope URLs	编辑范围外的范围前缀
Edit proxy listener	编辑代理侦听器
Edit request interception rule	编辑请求拦截规则
Edit scanning configuration	编辑扫描设置
Edit streaming URL	编辑流式URL
Edit streaming URL prefix	编辑流式URL的前缀
Edit target	编辑目标
Edit the selected cookie	编辑所选Cookie
Edit the selected custom parameter location	编辑所选定义参数位置
Edit the selected header	编辑所选头部
Edit the selected item	编辑所选项目
Edit the selected listener	编辑所选侦听器
Edit the selected macro	编辑所选宏
Edit the selected parameter	编辑所选参数
Edit the selected rule	编辑所选规则
Edit the selected task	编辑所选任务
Edit upstream proxy rule	编辑上行代理规则
Edited	编辑
Edited message	编辑后的消息
Edited request	编辑后请求
Edited response	编辑后的响应
Effective Entropy	有效熵
Embed images within HTML (requires modern browser)	在HTML中嵌入图片（需要最新的浏览器）
Embedded Browser Health Check	内置浏览器健康检查
Embedded browser health check	内置浏览器健康检查
Empty cookie jar	清空Cookie jar
Enable algorithms blocked by Java security policy (requires restart)	启用Java安全策略阻止的算法（需要重启）
Enable disabled form fields	激活无效的表单字段
Enable embedded browser sandbox (Windows only)	启用内置浏览器沙箱（仅限Windows）
Enable interception at startup:	启动时启用拦截：
Enable logging	激活日志
Enabled	启用
Encode	编码
Encode as ...	编码......
Encode as ASCII hex	编码为ASCII hex
Encrypted data to shuffle:	要加密的加密数据：
End	结束
End at delimiter:	以此分隔符结束：
End at fixed length:	以固定长度结束：
End time	结束时间
Engagement tools	相关工具
Engagement tools [Pro version only]	相关工具[仅限专业版]
Enter a comment	输入评论
Enter a new item	输入新项目
Enter license key	请输入许可证密钥
Enter master password	请输入主密码
Enter number of cells to delete	请输入要删除的单元格数
Enter number of cells to insert	请输入要插入的单元格数
Enter password	输入密码
Enter regex or leave blank	输入正则表达式或将其留空
Enter regex, IP range or leave blank	输入正则表达式、IP范围或将其留空
Enter the PIN code for your hardware token or smart card.	请输入硬件令牌或智能卡PIN码。
Enter the details of the parameter.	请输入参数的详细信息。
Enter the details of the payload processing rule.	请输入有效载荷处理规则的详细信息
Enter the details of the upstream proxy rule. You can use wildcards to specify destination hosts (* matches zero or more characters, ? matches any character except a dot). Leave the proxy host blank to connect directly for the specified destination host.	请输入上层代理的详细信息。您可以使用通配符（*表示零个或多个字母，？对于除点之外的任何字符）以指定目标主机。将代理主机留空以直接连接到指定的主机。
Enter the details of when the task should run. The task can be scheduled to run once at a specific time, or to repeat at a defined interval.	输入执行任务计划的详细时间。任务只能在指定时间执行一次，或者以指定的时间间隔重复执行。
Enter the full string to be submitted as the custom request header.	请输入要作为自定义请求标头发送的所有字符串。
Enter the hostname and IP address. Burp will use this setting instead of the DNS resolution provided by your computer.	请输入主机名和IP地址。使用此设置而不是计算机的DNS名称解析。
Enter the master password that was used to encrypt stored passwords.	请输入用于加密密码存储区的主密码。
Enter the master password to encrypt stored passwords. A strong password is recommended.	请输入主密码以加密密码存储区。建议使用强密码。
Enter the platform credentials for the specified destination host.	请输入目标主机平台凭据。
Entire body	全部主体
Entire body (for relevant content types)	全部主体（如果是相关内容类型）
Error	错误
Error messages	错误消息
Error reason	错误原因
Error-based	基于错误
Errors	错误
Errors:	错误：
Estimated encodings:	预期编码数量：
Event detail	事件详情
Event log	事件日志
Events	事件
Everything	所有
Exact	提取
Example	示例
Example:	示例:
Examples	示例
Examples:	示例:
Except for:	除以下情况外：
Exclude HTTP headers	排除HTTP标头
Exclude form field values	排除表单字段值
Exclude from scope	从范围中排除
Exclude headers	排除头部
Excluded URL prefixes	已排除的URL前缀
Excluded URLs	已排除的网址
Exit	结束
Exit Burp	退出Burp
Expand	展开
Expand branch	展开分支
Expand requested items	展开请求的项目
Expand the areas that you want to define in this configuration.	展开此设置定义的范围。
Expires	有效期限
Export	导出
Export Options	导出选项
Export comments	导出评论
Export configuration	导出设置
Export configurations	导出设置
Export scripts	导出脚本
Expression	表达式
Extension	扩展
Extension action handler:	扩展动作处理：
Extension file:	扩展文件：
Extension loaded	扩展加载
Extension payload generator:	扩展有效载荷生成器
Extension-generated	通过扩展生成(Extension-generated)
Extensions	扩展
Extensions - long	扩展 - 长
Extensions - short	扩展 - 短
Extensions let you customize Burp's behavior using your own or third-party code.	您可以使用自己或第三方代码自定义Burp的功能。
External / out-of-band interaction	外部/带外交互
Extract from regex group	从正则表达式组中提取
Extract the following items from responses:	从响应中提取以下项目：
Extracted value is URL-encoded	提取的值是URL编码的
Failed domain name resolution:	名称解析失败：
Failed parameters	参数失败
Failed to access file	访问文件失败
Failed to check for updates. Please log in to your account at https://portswigger.net to check for updates.	检查更新失败。通过https://portswigger.net登录您的帐户并检查更新。
Failed to decrypt stored passwords. Enter the master password that was used to encrypt stored passwords.	解密保存的密码失败。请输入用于加密密码存储区的主密码。
Failed to delete Burp executable.	删除Burp可执行程序失败。
Failed to download BApp file	下载BApp文件失败
Failed to load certificate: keystore password was incorrect	加载证书失败：密钥库密码不正确
Failed to open file	打开文件失败
Failed to open folder	打开文件夹失败
Failed to retrieve response	收取响应失败
Failed to save file. Please try another location.	保存文件失败。请尝试其他位置。
Failed to save project.	保存项目失败。
Failed to update BApp list	更新BApp列表失败
Failed to verify BApp file	BApp文件验证失败
Failed to verify integrity of download.	确认下载内容一致性失败。
False positive	错误检测
Fast	快速
February	2月
Feedback only contains technical information about Burp's internal functioning, and does not identify you in any way. If you do report a bug via email, you can help us diagnose any problems that your instance of Burp has encountered by including your debug ID.	反馈仅包含有关Burp内部功能的技术信息，无法识别您的身份。如果您通过电子邮件报告错误，包括您的调试ID将帮助您审计遇到的问题。
Fetch response	获取响应
Field name	字段名称
Field name cannot be blank	字段名称不能为空
Field name:	字段名称：
Field value	字段值
Field value:	字段值：
File	文件
File Extension	文件扩展名
File Extensions	文件扩展名
File already exists in the specified folder.	该文件已存在于指定的文件夹中。
File cannot be read or does not contain valid JSON	无法读取文件或找不到有效的JSON
File details:	文件详情：
File does not exist	文件不存在
File extension	文件扩展名
File extensions	文件扩展名
File for recovered project	恢复后的项目文件
File path traversal / manipulation	文件路径遍历/操作
File retrieval	文件获取
File was downloaded successfully.	该文件已成功下载。
File was saved successfully.	该文件已成功保存。
File:	文件：
Filenames	文件名
Filenames - long	文件名 - 长
Filenames - short	文件名 - 短
Files and directories	文件和目录
Files only	仅限文件
Filter	过滤器
Filter by MIME type	按MIME类型过滤
Filter by annotation	按注释过滤
Filter by extension	按扩展名过滤
Filter by file extension	按文件扩展名过滤
Filter by listener	按侦听器过滤
Filter by request type	按请求类型过滤
Filter by search term	按搜索字词过滤
Filter by search term [Pro only]	按搜索词过滤[仅限专业版]
Filter by status code	按状态码过滤
Filter:	过滤器：
Filter: 	过滤器：
Find comments	评论搜索
Find references	参考源搜索
Find scripts	脚本搜索
Finish	完成
Finished	已完成
Finished.	已完成.
Firm	貌似
Fixed	固定
Flag result items with responses matching these expressions:	将标志设置为与这些字符串匹配的响应：
Folder for loading library JAR files (optional):	用于读取库的JAR文件的文件夹（可选）：
Folder for loading modules (optional):	加载模块的文件夹（可选）：
Folders	文件夹
Follow redirection	跟随重定向
Follow redirection:	跟随重定向：
Follow redirections	跟随重定向
Follow redirections where necessary	在需要时跟随重定向重定向
Follow redirections:	跟随重定向：
Follow the redirection in the current response	遵循当前的响应重定向
Font	字体
Font size:	字体大小：
Font:	字体：
For this directory	此目录
For this file extension	此文件扩展名
Force use of SSL	强制使用SSL
Form Submission	表格提交
Form field names	表单字段名称
Form field values	表单字段值
Form field:	表格字段：
Form submissions	表格提交
Format of original data:	格式化原始数据：
Format strings	格式化字符串
Format:	形式:
Forms	表单
Forms queued:	表单队列：
Forward	发送
Frequently Occurring Insertion Points	高频率插入点
From this IP address	来自此IP地址
From this host	来此主机
Function	功能
Function fingerprint threshold:	指纹功能阈值：
Fuzzing - SQL injection	模糊测试 -  SQL注入
Fuzzing - XSS	模糊测试 -  XSS
Fuzzing - full	模糊测试 - 完整
Fuzzing - path traversal	模糊测试 - 路径遍历
Generate	生成
Generate CA-signed per-host certificates	为CA签名的每个主机生成证书
Generate CSRF PoC	CSRF PoC生成
Generate Collaborator payloads	协作者有效载荷生成
Generate a CA-signed certificate with a specific hostname:	生成由CA签名的指定主机名的证书：
Getting Started	入门
Getting Started With Burp Suite	Burp Suite入门
Getting started	入门
Go	发送
Go Up	移至上部
Go back	返回
Go forward	前进
Go to the next item in the history	移至历史记录中的下一个项目
Go to the previous item in the history	移至历史记录中的上一项
Hex	十六进制
HTML Rendering	HTML呈现
HTML-decode	HTML解码
HTML-encode all characters	HTML编码全部字符
HTML-encode all characters (hex entities)	HTML编码所有字符（请参阅十六进制数字字符）
HTML-encode all characters (numeric entities)	HTML编码所有字符（请参阅十进制数字字符）
HTML-encode key characters	HTML编码关键字符
HTTP Message Display	HTTP消息显示
HTTP header injection	HTTP标头注入
HTTP headers	HTTP头部
HTTP history	HTTP历史记录
HTTP method	HTTP方法
HTTP verbs	HTTP动词
Handle as ordinary forms	处理为正常形式
Handling Application Errors During Audit	处理审计期间的应用错误
Handling Application Errors During Crawl	处理爬行期间的应用程序错误
Hash ...	哈希......
Header cannot be blank	头部不能为空
Header manipulation	头部操作
Header:	头部：
Headers	请求头部
Help improve Burp by submitting anonymous feedback about its performance	匿名发送性能反馈以改善Burp
Hex	十六进制
Hex formatting	十六进制格式
Hide	隐藏
Hide all	隐藏全部
Hide details	隐藏细节
Hide empty folders	隐藏空文件夹
Hide finished items	隐藏已完成的项目
Hide incoming messages	隐藏入站邮件
Hide items without responses	隐藏没有响应的项目
Hide not-found items	隐藏不存在的项目
Hide outgoing messages	隐藏已发送的信息
Hide warning	隐藏警告
Hide:	隐藏:
High	高
High and medium issues	高、中风险问题
High issues	高风险问题
High severity	优先度高
High, medium and low issues	高，中，低风险问题
Highlight response syntax	高亮响应语法
History logging is disabled	历史记录已被禁用
History logging of out-of-scope items is disabled	超出范围的项目记录已被禁用
Host	主机
Host / IP range	主机/ IP范围
Host or IP range:	主机或IP范围：
Host, may include wildcards, or leave blank to apply to all hosts	主机（已启用通配符）或所有主机为空
Host:	主机：
Hostname	主机名
Hostname Resolution	主机名解析
Hostname:	主机名：
Hotkey	热键
Hotkeys	热键
Hours	小时
How many:	数量：
However, an overly short longest run of bits also indicates that the sample is not random.	但是，最长的位序列太短也表明样本不是随机的。
I Accept	我接受
I Decline	我拒绝
IIS files and directories	IIS文件和目录
IMPORTANT NOTICE: You should read all of the documentation about Burp Infiltrator before using it or inducing anyone else to use it. You should only use Burp Infiltrator in full understanding of its nature and the risks inherent in its utilization.	重要说明：在使用Burp Infiltrator或将其提供给其他人之前，您应该阅读所有文档。只有在您完全了解使用Burp Infiltrator的性质和风险时才应使用它。
IP address	IP地址
IP address:	IP地址：
Identifying items to audit.	识别要审计的项目。
If	如果
If not already present, add as:	如果它不存在，请将其添加为以下值：
If session is invalid, perform the action below:	如果会话无效，请执行以下操作：
If session is valid, don't process any further rules or actions for this request	如果会话有效，请不要对此请求处理进一步的规则或操作
If you wish to switch to the new project file, please exit Burp and re-start.	要切换到新的项目文件，请退出Burp并重新启动它。
Ignore	忽略
Ignore duplicate items based on URL and parameter names	根据URL和参数名称忽略重复的项目
Ignore form	忽略形式
Ignore links to non-text content	忽略非文本内容的链接
Ignore these headers:	忽略这些头部：
Ignore these parameters:	忽略这些参数：
Ignore tokens whose length deviates by	忽略不同长度的令牌
Ignore whitespace-only variations	忽略仅空白值
Ignored Insertion Points	忽略插入点
Illegal UTF-8 continuation bytes	非法UTF-8延续字节
Illegal Unicode	非法Unicode(Illegal Unicode)
Illegal hex characters	非法十六进制字符
Images	图片
Immediately	立即
Import	进口
Import / export CA certificate	导入/导出CA证书
Import completed	导入完成
Import configurations	导入设置
Import legacy state file	导入旧的状态文件
Import project	导入项目
Import project [disk projects only]	导入项目[仅限光盘项目]
Import project file	导入项目文件
Import project file [disk projects only]	导入项目[仅限光盘项目]
In	在
In current browser session	使用当前浏览器会话
In current session	在当前会话
In future, just copy the URL and don't show this dialog	从现在开始，自动复制URL，不显示此对话框。
In original session	使用原始会话
In request does not match	与请求不匹配
In request matches	根据请求匹配
In response does not match	它与响应中的一个不匹配
In response matches	匹配响应
In-band	带内
In-scope only	仅限范围之内
Include Burp Collaborator identifier in the state file	在状态文件中包含Burp Collaborator标识符
Include Collaborator server location	包括Collaborator服务器位置
Include URLs in export	包含导出中的URL
Include all URLs	包含所有URL
Include auto-submit script	包含自动提交脚本
Include columns:	包括列：
Include form field values	包含表单字段值
Include full requests	包含完整的请求
Include full responses	包括完整的响应
Include headers	包括头部
Include in scope	包括范围之内
Include in-scope items only	仅包含在范围项中
Include relevant extract	包含相关部分提取
Included URL prefixes	包含的URL前缀
Included URLs	包含的网址
Individuate forms by:	个性化表单：
Info	信息
Information	信息
Information disclosure	信息泄漏
Informational	信息
Informed	通知
Initial payload for first request:	为第一个请求初始化有效载荷：
Insensitive	忽略大小写
Insert a new payload marker	插入新的有效载荷标记
Insert byte	插入字节
Insert bytes ...	插入多个字节......
Insert cells	插入一个单元格
Insert string	插入字符串
Insert string ...	插入字符串......
Insertion Point Types	插入点类型
Insertion point	插入点
Insertion points	插入点
Inspect response to determine session validity:	验证对会话有效性决策的响应：
Install	安装
Installed	安装
Installing	安装中
Installing...	安装中......
Intercept	截断
Intercept Client Requests	拦截客户端请求
Intercept Server Responses	服务器响应拦截
Intercept WebSockets Messages	拦截WebSocket消息
Intercept WebSockets messages	拦截WebSocket消息
Intercept client-to-server messages	拦截从客户端到服务器的消息
Intercept is off	拦截已关闭
Intercept is on	拦截已开启
Intercept requests based on the following rules:	拦截基于以下规则的请求：
Intercept responses based on the following rules:	拦截基于以下规则的响应：
Intercept server-to-client messages	拦截从服务器到客户端的消息
Interface	接口
Intruder Attack Configuration	攻击器攻击设置
Intruder results help	攻击器结果帮助
Intrusive	侵入
Intrusive active	主动扫描（入侵）
Invalid Port:	无效端口：
Invalid URL	无效URL
Invalid URL prefix	无效URL前缀
Invalid URL prefix, use advanced scope control for regex capability.	无效URL前缀。在高级范围设置使用正则表达式函数。
Invalid URL prefix.	无效URL前缀。
Invalid URL:	无效URL：
Invalid custom location configuration	自定义位置设置无效
Invalid date	非法日期
Invalid delay between requests	请求之间的权重无效
Invalid destination host specification	指定的目标主机无效
Invalid from value	表单值无效
Invalid host specification	指定主机无效
Invalid length	无效长度值
Invalid maximum concurrent requests	最大并发请求数无效
Invalid number	无线数字
Invalid poll interval	无效轮询间隔
Invalid port:	无效的端口：
Invalid proxy port	无效代理端口号
Invalid regex	无效正则表达式
Invalid session	无效会话
Invalid value	无效的值
Invisible	透明
Invisible proxy support allows non-proxy-aware clients to connect directly to the listener.	通过支持透明代理，代理不兼容的客户端可以直接连接到侦听器。
Invoke Burp extension	调用Burp扩展
Invoke a Burp extension	调用Burp扩展
Is	一致
Is HTTP	HTTP
Is HTTPS	HTTPS
Is in range	在范围内
Is in target scope	在目标范围内
Is media	不是媒体文件
Is not in range	不再范围之内
Is not media	不是媒体内容
Is not text	不是文本内容
Is text	是文本内容
Issue Definitions	问题定义
Issue activity	问题活动
Issue background	问题背景
Issue current request	发出当前请求
Issue definitions	问题定义
Issue detail [where applicable]	问题详情[如果适用]
Issue organization	问题编成
Issue persistence within the queue items was disabled. If required, it can be enabled within Scanner Options.	队列项中问题的持久性已失效。如有必要，您可以使用“扫描仪”选项启用它。
Issue the request	发送请求
Issue the request to obtain the response	发送请求以获得响应
Issue type	问题类型
Issuer	问题发起人
Issues	问题
Issues Reported	要报告的问题
Issues documentation	问题文档
Issues help	问题查看帮助
Issues:	问题:
Item	项目
Items added to site map:	添加到Sitemap的项目：
Items on the same domain	同一域中的项目
Items to Scan	要扫描的项目
Iterate all values of submit fields - max submissions per form:	枚举发送字段的所有值 - 每个表单的最大传输数：
January	1月
Java Environment	Java环境
Java SSL Options	Java SSL选项
JavaScript Analysis	JavaScript解析
JavaScript analysis	JavaScript解析
JavaScript-driven	JavaScript驱动
Javascript dynamic analysis	Javascript动态解析
Javascript static analysis	Javascript静态解析
July	7月
June	6月
Key	关键
Label	标签
Label:	标签：
Last updated	上次更新
Last used	上次使用
Leave	离开
Left/right split	左右分开
Length	长度
Library	图书馆
Licence Agreement	许可证协议
License	许可证
Light	轻量
Limit to	限制于
Link depth to associate with Proxy requests:	与代理请求关联的链接深度：
Link fingerprint trigger:	链接指纹触发器：
Link manipulation	链接操作
Links	链接
Linux installer	Linux安装程序
Listener port	侦听端口
Literal string	文字字符串
Literal string or regex field name	正则表达式的文字字符串或字段名称
Literal string to replace - leave blank to remove a matched header	替换字符串 - 如果要删除匹配的头部，请留空
Literal string to use as field value	文字字符串或正则表达式字段值
Literal value	字面值
Live Capture Options	实时捕捉选项
Live Passive Scanning	实时被动扫描
Live audit	实时审计
Live capture	实时捕捉
Live capture (stopped)	实时捕捉（已停止）
Live config editing	编辑实时设置
Live passive crawl	实时被动爬行
Live passive crawling	实时被动爬行
Live scanning	实时扫描
Load	加载
Load ...	加载......
Load Burp Collaborator server options	加载Burp Collaborator服务器选项
Load Burp Extender options	加载Burp Extender选项
Load Burp Extension	加载Burp扩展
Load HTML rendering options	加载HTML呈现选项
Load HTTP message display options	加载HTTP消息显示选项
Load Java environment options	加载Java环境选项
Load Python environment options	加载Python环境选项
Load Ruby environment options	加载Ruby环境选项
Load SOCKS proxy options	加载SOCKS代理选项
Load SSL negotiation options	加载SSL协商选项
Load SSL negotiation workarounds options	加载SSL协商解决方法选项
Load SSL passthrough options	加载SSL传递选项
Load active scanning areas options	加载活动扫描目标选项
Load active scanning engine options	加载活动扫描引擎选项
Load active scanning optimization options	加载主动扫描优化选项
Load application login options	加载应用程序登录选项
Load attack config	加载攻击设置
Load attack insertion points options	加载攻击插入点选项
Load attack results options	加载攻击结果选项
Load automatic project backup options	加载自动项目备份选项
Load character set options	读取字符集选项
Load client SSL certificates options	加载客户端SSL证书选项
Load cookie jar options	阅读cookie jar选项
Load crawler options	加载爬行程序选项
Load custom lists from directory:	从目录中读取自定义列表：
Load data from file	从文件中读取数据
Load extract grep options	加载提取的grep选项
Load form submission options	加载表单提交选项
Load from Burp project file	从Burp项目文件中读取
Load from Burp state file	从Burp状态文件中读取
Load from Burp state file [Pro version only]	从Burp状态文件中读取[仅限专业版]
Load from configuration file	从文件中读取设置
Load hostname resolution options	加载主机名解析选项
Load hotkey options	加载热键选项
Load intercept WebSockets messages options	加载WebSocket消息的拦截选项
Load intercept client requests options	加载客户端请求的拦截选项
Load intercept server responses options	读取服务器响应拦截选项
Load items from file	从文件中读取项目
Load live active scanning options	加载实时活动扫描选项
Load live capture options	加载实时捕获选项
Load live passive scanning options	加载实时被动扫描选项
Load logging options	加载日志记录选项
Load macros options	加载宏选项
Load match and replace options	加载搜索和替换选项
Load match grep options	加载匹配grep选项
Load miscellaneous proxy options	加载其他代理选项
Load miscellaneous proxy settings options	加载其他代理设置选项
Load options	加载选项
Load out-of-scope requests options	读取超出范围的请求选项
Load passive scanning areas options	读取被动扫描区域选项
Load passive spidering options	加载被动蜘蛛选项
Load payloads grep options	加载有效载荷grep选项
Load performance feedback options	加载性能反馈选项
Load platform authentication options	加载平台认证选项
Load project options	加载项目选项
Load proxy history logging options	读取代理历史日志选项
Load proxy interception options	读取代理拦截选项
Load proxy listeners options	加载代理侦听器选项
Load redirections options	加载重定向选项
Load request engine options	加载请求引擎选项
Load request headers options	读取请求标头选项
Load response modification options	读取响应操作选项
Load rest api options	加载REST API选项
Load scan issues options	读取扫描项目选项
Load scheduled tasks options	加载计划任务选项
Load server SSL certificates options	加载服务器SSL证书选项
Load session handling rules options	加载会话处理规则选项
Load spider engine options	加载蜘蛛引擎选项
Load spider scope options	加载Spider范围选项
Load static code analysis options	加载静态代码分析选项
Load status 100 responses options	读取状态100响应选项
Load streaming responses options	加载流响应选项
Load target scope options	加载目标范围选项
Load temporary files location options	加载临时文件位置选项
Load timeouts options	加载超时选项
Load token analysis options	加载令牌分析选项
Load token handling options	加载令牌处理选项
Load upstream proxy servers options	加载更高级别的代理服务器选项
Load user interface options	加载用户界面选项
Load user options	加载用户选项
Loaded	已加载
Loading project file ...	加载项目文件......
Loading project...	加载项目......
Loading tokens	加载令牌
Locating authenticated functionality (random). Estimating time remaining...	识别认证功能（随机）。评估剩余时间......
Location of JRuby JAR file:	JRuby JAR文件位置：
Location of Jython standalone JAR file:	Jython独立JAR文件位置：
Location(s):	位置:
Locations	位置
Logging	记录
Logging of out-of-scope Proxy traffic is disabled	记录超出范围的代理流量已禁用
Login Functions	登录功能
Longest:	最长:
Look and feel:	外观：
Look for expression:	外观正则表达式：
Loopback only	仅限环回
Low	低
Low severity	优先度低
MIME type	MIME类型
MSSQL-specific checks	指定MSSQL检查
Mac OS installer	Mac OS安装程序
Macro Editor	宏编辑器
Macro Recorder	宏记录器
Macro Tester	宏测试器
Macro description:	宏描述：
Macro editor help	宏编辑器帮助
Macro items:	宏项目：
Macro tester help	宏测试器帮助
Make a non-parameterized request to each dynamic page	向每个动态页面发送无参数请求
Make request(s) to validate session:	请求验证会话：
Make requests for missing JavaScript dependencies	请求缺少JavaScript依赖项
Make unmodified baseline request	生成未修改的基本请求
Manual Activation	手动激活
Manual Load	手动加载
Manual Testing Simulator	手动测试模拟器
Manual activation	手动激活
Manual install ...	手动安装......
Manual load	手动加载
Manual testing simulator	手动测试模拟器
Manually select library:	选择图书馆：
March	3月
Master interception is turned off     	主拦截被关闭
Master password:	主密码：
Match	匹配
Match / replace in list items	匹配和替换列表项
Match against pre-URL-encoded payloads	在URL编码之前匹配有效载荷
Match and Replace	匹配和替换
Match character:	匹配字符：
Match condition cannot be blank	匹配字符串不能为空
Match condition:	匹配条件：
Match expression:	匹配表达式：
Match indicates:	匹配指示：
Match item:	搜索项目：
Match parameter names only	仅匹配参数名称
Match regex:	匹配正则表达式：
Match relationship:	匹配关系：
Match type	匹配类型
Match type:	匹配类型：
Match/replace	匹配/替换
Match:	匹配：
Matches	匹配
Matches regex	匹配正则表达式
Max concurrent requests	最大并发请求数
Max depth:	最大深度:
Max fraction digits:	最大分数位数：
Max integer digits:	最大整数位数：
Max length:	最大长度:
Max state changing sequences:	最大状态变化顺序：
Max submissions per form:	每张表格的最大传输次数：
Max unmatched link tolerance:	最大链接允许数量：
Maximize permutations in multi-byte encodings	最大化多字节字符的组合
Maximum Entropy Bits	最大熵位
Maximum analysis time per item (seconds):	每个项目的最大分析时间（秒）：
Maximum capture length:	提取的最大长度：
Maximum concurrent requests:	最大并发请求数：
Maximum crawl time:	最大抓取时间：
Maximum dynamic analysis time per item (in seconds):	每个项目的最大动态分析时间（秒）：
Maximum insertion points per base request:	每个基本请求的最大插入点数：
Maximum length:	最大长度:
Maximum link depth:	最大链接深度：
Maximum parameterized requests per URL:	每个URL的最大参数化请求数：
Maximum payloads per item:	每个项目的有效载荷数量：
Maximum request count:	最大请求数：
Maximum static analysis time per item (in seconds):	每个项目的最大静态分析时间（秒）：
Maximum unique locations discovered:	发现的最大唯一位置数：
May	5月
Medium	中
Medium active	主动扫描（中）
Medium severity	优先度中
Message	信息
Message Editor	消息编辑器
Message editor documentation	消息编辑器的文档
Message editor help	消息编辑器帮助
Meta refresh tag	元刷新标签
Method	方法
Method:	方法：
Mime type	MIME类型
Min fraction digits:	最小分数位数：
Min integer digits:	最小整数位数：
Min length:	最短长度:
Minimize false negatives	最大限度地减少检测泄漏
Minimize false positives	尽量减少过度检测
Minutes	分分钟
Minutes between backups:	备份间隔（分钟）：
Misc	杂项
Misc Insertion Point Options	其他插入点选项
Miscellaneous	杂项
Missing help	缺少帮助
Modified value:	修改值：
Modify case	修改大小写
Modifying Parameter Locations	修改参数位置
Monitor the following tools' traffic to update the cookie jar:	监视以下工具并更新cookie jar：
Months	月
Move down	向下移动
Move the selected certificate down	向下移动所选证书
Move the selected certificate up	向上移动选定的证书
Move the selected header down	向下移动选定的头部
Move the selected header up	向上移动选定的头部
Move the selected item down	向下移动所选项目
Move the selected item up	向上移动所选项目
Move the selected macro down	向下移动选定的宏
Move the selected macro up	向上移动选定的宏
Move the selected parameter down	向下移动所选参数
Move the selected parameter up	向上移动所选参数
Move the selected rule down	向下移动所选规则
Move the selected rule up	移动所选规则
Move to the next match	转到下一个匹配
Move to the previous match	转到上一个匹配
Move up	向上移动
Multipart form	多部分表格
MySQL specific	指定MySQL
MySQL-specific checks	指定MySQL检查
NOTE: You should ensure that all valuable data is saved elsewhere before using this function. Using this function will cause Burp to exit.	注意：在使用此功能之前，请确保将重要数据保存在其他位置。使用此功能将结束Burp。
NOTE: license activations are monitored. If you perform too many activations, further activations for this license may be prevented.	注意：监视许可证激活。如果激活太多，我们可能会停止进一步激活此许可证。
Name	名称
Name or value:	名称或值：
Name validation error	名称校验错误
Name:	名称：
Names observed in use on target site	目标站点中使用的名称
Negative match	不匹配的项目
Negative search	未搜索到的项目
Nested insertion points are used when an insertion point's base value contains data in a recognized format (for example, XML data within a URL parameter):	如果插入点的源值是可识别的形式（例如，URL参数中的XML数据），则使用嵌套的插入点：
Never	永远不要
New	新的
New ...	新的......
New API key	新的API密钥
New Login Credentials	新的登录凭据
New application login configuration	新的应用程序登录设置
New auditing configuration	新的审计设置
New crawling configuration	新的抓取设置
New live passive crawling configuration	新的被动爬行设置
New live task	新的实时任务
New live task 	新的实时任务
New project file	新项目文件
New project name:	新项目名称：
New project on disk	新磁盘项目
New resource pool	新资源池
New scan	新扫描
New scan 	新扫描
New scanning configuration	新的扫描设置
New tab behavior	新标签行为
New...	新......
Newer project file detected	检测新项目文件
Next	下一个
No	没有
No actions defined	没有定义动作
No anomalies were identified in this test.	在该测试中未发现异常。
No certificate is selected	未选择证书
No change	没有变化
No delay between requests value specified	未指定请求之间的权重
No generators defined	生成器未定义。
No library is selected	未选择库
No macro selected	未选择宏
No maximum concurrent requests value specified	未指定的最大并发请求数
No name provided	未指定名称
No name specified	未指定名称
No processors defined	没有定义处理器
No proxy listeners are currently running - go to the Options tab to enable a listener	代理侦听器未运行 - 请在选项选项卡上激活侦听器。
No summary chart	没有摘要图表
No summary table	没有汇总表
None	无
Normal	正常
Normal:	正常
Not available in Community Edition	在社区版本中无法使用
Not available in demo version	在演示版中无法使用
Not available in free edition	在免费版本中无法使用
Not defined	未定义
Note that statistical tests provide only an indicative guide to the randomness of the sampled data. Results obtained may contain false positives and negatives, and may not correspond to the practical predictability of the tokens sampled.	请注意，统计测试仅提供样本数据随机性的指南。获得的结果包括假阳性和假阴性，并且可能不对应于采样令牌的实际预测。
Note that the FIPS specification for this test only records a fail if the longest run of bits is overly long.	请注意，在此测试的FIPS规范中，仅当最长的位序列太长时才会失败。
Note that the request currently being processed by this session handling rule will still be issued, so the macro should not include this request unless it is necessary to issue it twice.	仍会发出当前正在为此会话处理规则处理的请求，因此如果您不需要发出两个请求，则不应在宏中包含此请求。
Note: Character-level analysis was not performed because the sample size is too small relative to the size of the character set used in the sampled tokens.	注意：由于样本大小与样本标记中使用的字符集大小相比非常小，因此不会执行字符级别分析。
Note: Disk-based projects are not supported on 32-bit operating systems.	注意：32位操作系统不支持基于磁盘的项目。
Note: Disk-based projects are only supported on Burp Suite Professional.	注意：只有Burp Suite Professional Edition支持基于磁盘的项目。
Note: Exercise caution when running Burp Clickbandit on untrusted websites. Malicious JavaScript from the target site can subvert the HTML output that is generated by Burp Clickbandit.	注意：在不受信任的网站上运行Burp Clickbandit时要小心。目标站点上的无效脚本可能会破坏Burp Clickbandit生成的HTML输出。
Note: It is not recommended to restore configuration from a state file that originated from an untrusted source.	注意：我们不建议从不受信任的来源收到的状态文件中恢复设置。
Note: Some of the selected items do not yet have responses. If you choose to remove items with media responses, some of these items may be removed from the scan when their responses have been analyzed.	注意：部分选定项目尚未响应。如果您选择排除媒体响应项，则在响应分析完成时，这些项将从扫描中排除。
Note: Some of these options are not available in the Community Edition of Burp.	注意：某些选项对Burp社区版本无效。
Note: Some of these options are not available in the Free Edition of Burp.	注意：某些选项对Burp Free版本无效。
Note: This analysis is based on the current contents of the site map, and no new requests have been made. Only parameters within the query string and request body are included in the analysis. URLs identified as "static" are those which do not take any parameters, though their responses may still be dynamically generated.	注意：此分析基于站点地图的当前内容，并且未生成新请求。只有查询字符串和请求正文中的参数才包含在分析中。标识为“静态”的URL没有参数，但可能是动态生成响应。
Note: You have selected to remove items with media responses. Some of the above items do not yet have responses and so may be removed from the scan when their responses have been analyzed.	注意：选择删除媒体响应项。上述某些项目尚未得到响应，并且在完成响应分析时，这些项目将被排除在扫描范围之外。
Note: these settings can be overridden for individual projects within project options.	注意：这些设置可以被各个项目的项目选项覆盖。
Note: you should not delete these files if another instance of Burp is currently running.	注意：如果当前正在运行其他Burp实例，请不要删除这些文件。
Note: you should not disclose the private key for your CA certificate to any untrusted party.	注意：您不应向不受信任方披露CA证书私钥。
November	11月
Null payloads	空载荷(Null payloads)
Number format	数字格式
Number of URLs	URL数
Number of discovery threads:	搜索线程数：
Number of dynamic URLs:	动态URL数:
Number of retries on network failure:	网络错误的重试次数：
Number of spider threads:	蜘蛛线程数量：
Number of static URLs:	静态URL数:
Number of threads:	线程数：
Number of unique parameter names:	具有唯一名称的参数数量：
Number range	数字范围
Number to generate:	生成数字:
Numbers	数值(Numbers)
October	10月
Of request does not match	与请求不匹配
Of request matches	匹配请求
Of response does not match	与响应不匹配
Of response matches	匹配响应
On completion of crawl, do	旅游结束后，
On completion of each audit phase, do	完成每个审计阶段后，
On-site only	只有同一个网站
On:	开启:
Once configured, you can browse the API documentation and interact with the API at: Service URL/API key.	设置完成后，您可以浏览API文档，并可以使用服务URL / API密钥与API进行通信。
Once configured, you can browse the API documentation and interact with the API at: [Service URL]/[API key].	设置完成后，您可以浏览API文档，并可以使用[服务URL] / [API密钥]与API进行通信。
Online activation	在线激活
Open backup	打开备份
Open config file	打开配置文件
Open cookie jar	打开Cookie jar
Open existing project	打开现有项目
Open in browser	在浏览器中打开
Open project file	打开项目文件
Open recovered project	打开恢复的项目
Open saved attack	打开保存的攻击
Open scan launcher	打开扫描启动器
Open sessions tracer	打开会话跟踪器
Open the cookie jar	打开Cookie jar
Open the sessions tracer	打开会话跟踪器
Open-ended responses:	从响应的开始到结束：
Operate on:	处理对象：
Operator	动作
Options	选项
Oracle specific	指定Oracle
Oracle-specific checks	指定Oracle检查
Original message	原始消息
Original request	原始请求
Original response	原始响应
Other binary	其他二进制
Other text	其他文本
Out-of-Scope Requests	超出范围的请求
Output	输出
Output to system console	输出到系统控制台
Overall result	总体结果
Overlong UTF-8 encodings	冗余UTF-8编码
Override user options	覆盖用户选项
PIN code is required	需要PIN码
PIN code:	PIN 码：
Pad short tokens at:	填充短标记：
Pad with (single character or 2-digit ASCII hex code):	填充字符（1或2位ASCII十六进制代码）：
Page title	页面头部
Param name	参数名称
Param value	参数值
Parameter	参数
Parameter Scope	参数范围
Parameter handling	参数处理
Parameter name	参数名称
Parameter name must be specified	必须指定参数名称
Parameter name:	参数名称：
Parameter:	参数：
Parameters	参数
Parameters:	参数：
Params	参数
Pass back to the invoking tool:	将其传递给正在运行的工具：
Passive	被动
Passive Scanning Areas	被动扫描区域
Passive Spidering	被动蜘蛛戒指
Passive checks	被动检查
Passive phases	被动阶段
Passive spidering monitors traffic through Burp Proxy to update the site map without making any new requests.	被动蜘蛛爬行不会生成新请求，并通过监视Burp代理流量来更新站点地图。
Passively scan all traffic through Proxy	被动扫描通过代理服务器的所有流量
Passively scan selected items	被动扫描所选项目
Passively scan this branch	被动扫描此分支
Passively scan this host	被动扫描此主机
Passively spider as you browse	从浏览器访问进行被动蜘蛛爬取
Password	密码
Password is required	密码是必需的
Password:	密码：
Passwords	密码
Passwords within configuration options:	设置密码：
Paste	粘贴
Paste URL	粘贴网址
Paste URL as request	将URL粘贴为请求
Paste data from the clipboard	粘贴剪贴板中的数据
Paste from file	从文件粘贴
Paste one or more items from the clipboard	从剪贴板粘贴一个或多个项目
Paste response	粘贴响应
Pasted value is not a valid URL	粘贴的值不是有效的URL
Path	路径
Path:	路径：
Pause	暂停
Pause Automated Tasks	暂停自动任务
Pause Scanner	暂停扫描器
Pause Spider and Scanner	暂停蜘蛛和扫描
Pause active scanning	暂停主动扫描
Pause all tasks	暂停所有任务
Pause before retry (milliseconds):	重试前暂停（ms）：
Pause scanner	暂停扫描器
Pause spidering	暂停蜘蛛任务
Pause task execution engine	暂停任务执行引擎
Pause the task if:	暂停任务条件：
Paused	已暂停
Paused.	已暂停.
Payload	有效载荷
Payload Encoding	有效载荷编码
Payload Options	有效载荷选项
Payload Options [Bit flipper]	有效载荷选项[bit flipper]
Payload Options [Brute forcer]	有效载荷选项[暴力]
Payload Options [Case modification]	有效载荷选项[案例转换]
Payload Options [Character blocks]	有效载荷选项[字符块]
Payload Options [Character frobber]	有效载荷选项[字符栏]
Payload Options [Character substitution]	有效载荷选项[字符替换]
Payload Options [Copy other payload]	有效载荷选项[复制其他有效载荷]
Payload Options [Custom iterator]	有效载荷选项[自定义迭代器]
Payload Options [Dates]	有效载荷选项[日期]
Payload Options [ECB block shuffler]	有效载荷选项[ECB Block Shuffle]
Payload Options [Extension-generated]	有效载荷选项[由扩展程序生成]
Payload Options [Illegal Unicode]	有效载荷选项[非法Unicode]
Payload Options [Null payloads]	有效载荷选项[无有效载荷]
Payload Options [Numbers]	有效载荷选项[数字]
Payload Options [Recursive grep]	有效载荷选项[递归搜索]
Payload Options [Runtime file]	有效载荷选项[运行时文件]
Payload Options [Simple list]	有效载荷选项[简单列表]
Payload Options [Username generator]	有效载荷选项[用户名生成]
Payload Positions	有效载荷位置
Payload Processing	有效载荷处理
Payload Set:	有效载荷集：
Payload Sets	有效载荷集
Payload count:	有效载荷数量：
Payload set:	有效载荷集：
Payload type:	有效载荷类型：
Payloads	有效载荷
Per-host	每主机
Perform a word-level comparison of the two selected items	在单词级别比较选定的两个项目
Performance Feedback	性能反馈
Place attacks into the following locations within requests:	将攻击放在请求中的以下位置：
Place payloads into the following locations within requests:	将有效载荷放在以下位置的请求中：
Plain JAR file	JAR文件
Plain text form	纯文本表格
Platform Authentication	平台认证
Please enter a config file	请输入配置文件
Please enter a name for the new configuration	请输入新的设置名称
Please enter platform credentials for this request.	请输入此请求的平台凭据。
Please enter the URL you would like to scan from. Note that this task will perform active scanning on the specified URL and on all items beneath it in its branch of the site map.	请输入URL以开始扫描。请注意，将在此处指定的URL的所有站点地图上的分支上执行主动扫描。
Please enter the URL you would like to spider from.	请输入URL以开始自动巡逻。
Please enter the details of the extension, and how you would like to handle standard output and error.	请输入扩展的详细信息以及如何处理标准输出和错误。
Please enter the new project name.	请输入新的项目名称。
Please enter your new license key.	请输入新的许可证密钥。
Please log in to /users/ and download Burp manually.	请登录/ users /并手动下载Burp。
Please log in to https://portswigger.net/users and download Burp manually.	登录https://portswigger.net/users并手动下载Burp。
Please note that state files are deprecated. State files no longer save or restore configuration, only data. You are recommended to use project files instead of state files.	不推荐使用状态文件。只能在状态文件中保存和读取数据，并且无法保存设置。我们建议使用项目文件而不是状态文件。
Please provide a name for this configuration	请输入此设置的名称
Please read the following licence agreement carefully, and indicate whether you accept its terms.	请阅读以下许可协议，并说明您是否同意这些条款。
Please read the following terms and conditions carefully, and indicate whether you accept their terms.	请阅读以下许可协议，并说明您是否同意这些条款。
Please select a directory	请选择一个目录
Please select a file	请选择一个文件
Please select a file for the recovered project	请选择已还原项目文件的保存目标
Please select a folder	请选择一个文件夹
Please select a project file	请选择一个项目文件
Please select a rule type	请选择规则类型
Please select an empty directory	请选择一个空目录
Please select the JRuby JAR file	请选择JRuby的JAR文件
Please select the Jython standalone JAR file	请选择Jython独立JAR文件
Please select the application type	请选择申请类型。
Please select the build that you want to download.	请选择要下载的版本。
Please select the file for the recovered project.	请选择已还原项目文件的保存目标。
Please select the file for the repaired project.	请选择已修复项目文件的保存目标。
Please select the file you would like to save to.	请选择要保存的文件。
Please select the folder for loading modules	请选择要加载模块的文件夹
Please supply a prefix	请指定前缀
Please supply a regex	请指定正则表达式
Please supply a suffix	请指定后缀
Please visit https://portswigger.net for more details about Burp Suite Professional which contains the full version. 	有关具有完整版本的Burp Suite Professional版本的详细信息，请访问https：//portswigger.net。
Please visit https://portswigger.net/burp/freedownload/ to download the latest version.	转到https://portswigger.net/burp/freedownload/并下载最新版本。
Please wait	请稍等
Please wait ...	请稍等......
Poll Collaborator interactions	轮询协作者交互
Poll every	轮询间隔
Poll now	现在轮询
Poll over unencrypted HTTP	使用未加密的HTTP进行轮询
Polling location (optional):	轮询位置（可选）：
Popularity	声望
Port	端口
Port:	端口：
Position	位置
Position:	位置:
Positions	位置
Predefined Payload Lists	预定义的有效载荷列表
Prefix	前缀
Prefix:	前缀：
Prepend preprocessed payload	在开头添加预处理器有效载荷
Preset Payload Lists	预定义的有效载荷列表
Preset parameters	预设参数
Preset schemes:	预定义格式：
Previous	前
Private key in DER format	DER格式的密钥
Process cookies in redirections	在重定向期间处理cookie
Project file: 	项目文件：
Project options	项目选项
Project saved successfully.	该项目已成功保存。
Prominently highlight unhidden fields	突出显示强制显示字段
Prompt for action	选择每个操作
Prompt for credentials on platform authentication failure	平台身份验证失败时显示凭据提示
Prompt for guidance	显示指导
Prompt for in-browser session recovery	提示浏览器内会话恢复
Protocol	协议
Protocol:	协议：
Proxy (all traffic)	代理（所有流量）
Proxy (use with caution)	代理(使用注意)
Proxy History Logging	代理历史记录
Proxy Interception	代理拦截
Proxy Listeners	代理侦听器
Proxy history documentation	代理历史文档
Proxy history help	代理历史帮助
Proxy history logging	代理历史记录
Proxy host	代理主机
Proxy host, leave blank to connect directly	代理主机，如果直接连接则留空
Proxy host:	代理主机：
Proxy interception help	代理拦截帮助
Proxy port	代理端口
Proxy port:	代理端口：
Purchase Burp Suite Professional	购买Burp Suite专业版
Purpose:	目的:
Python Environment	Python环境
Queued Tasks	队列任务
Random	随机
Rating	评级
Rating:	评级：
Raw	原始值
Re-analyze macro	重新解析宏
Re-analyzing the macro may alter the parameter configuration of macro items. Are you sure you want to continue?	重新分析宏时，宏项的参数设置会发生变化。你想继续吗？
Re-colorize the display based on the current payload markers	使用当前有效载荷标记重新着色显示
Re-enable	重新启用
Re-enter license key	重新输入许可证密钥
Re-record macro	记录宏
Re-recording the macro will delete the current macro items. Are you sure you want to continue?	重新录制宏时，将删除当前宏项。你想继续吗？
Ready	准备完毕
Recent destinations buffer size:	最近的目标缓冲区大小：
Recognize automatically based on message headers	从邮件头部中自动识别
Record a new macro	记录新的宏
Record macro	记录宏
Record the macro items	记录宏项目
Recovering project data	正在恢复的项目数据
Recurse subdirectories	递归子目录
Recursive grep	递归Grep(Recursive grep)
Redirect	重定向
Redirect to host:	重定向目标主机：
Redirect to port:	重定向目标端口：
Redirections	重定向
Redo analysis	重做分析
References	参照
Refetch response	重新获取响应
Reflected DOM issues	反射型DOM问题
Reflected XSS	反射型XSS
Refresh	刷新
Refresh header	刷新头部
Refresh list	刷新列表
Refreshing...	重新刷新中......
Regenerate	再生成
Regenerate CA certificate	再次生成CA证书
Regex	正则表达式
Regex condition to match - leave blank to add a new header	搜索条件 - 为新头部添加留空
Regex match	正则表达式匹配
Registering a user. Estimating time remaining...	用户注册正在进行中。评估剩余时间......
Regular expression	正则表达式
Reinstall	重新安装
Relationship	关系
Release notes	发行说明
Release notes   	发行说明
Release notes:   	发行说明：
Reliability	可信性
Remediation background	重置背景
Remediation detail [where applicable]	重置详情[适用时]
Remove	删除
Remove 100 Continue headers	删除100个“Continue”头部
Remove <object> tags	删除<object>标记
Remove Burp license key	删除Burp的许可证密钥
Remove Burp program executable	删除Burp执行程序
Remove JavaScript form validation	删除JavaScript表单验证
Remove all JavaScript	删除所有JavaScript
Remove all items from the cookie jar	从cookie jar中删除所有项目
Remove all items from the list	从列表中删除所有项目
Remove cookie	删除cookie
Remove duplicate comments	删除重复的评论
Remove duplicate items (same URL and parameters) [calculating...]	删除重复的项目（相同的URL和参数）[计算中...]
Remove duplicates	删除重复项
Remove dupulicate comments	删除重复的评论
Remove from scope	从范围中删除
Remove input field length limits	删除输入字段长度限制
Remove item	删除项目
Remove items with no parameters [calculating...]	删除没有参数的项目[计算中...]
Remove out-of-scope items (based on current suite scope)	删除范围外的项目（基于当前的总体范围）
Remove out-of-scope items (based on current suite scope) [calculating...]	删除范围外的项目（基于当前的总体范围）
Remove saved configuration files	删除保存的设置文件
Remove saved preferences	删除保存的设置
Remove secure flag from cookies	从cookie中删除安全属性
Remove temporary files	删除临时文件
Remove the selected certificate	删除所选证书
Remove the selected cookie	删除所选的cookie
Remove the selected custom parameter location	删除自定义参数位置
Remove the selected header	删除所选头部
Remove the selected item	删除所选项目
Remove the selected items	删除所选项目
Remove the selected listener	删除选定的侦听器
Remove the selected macro	删除选定的宏
Remove the selected parameter	删除所选参数
Remove the selected rule	删除所选规则
Remove the selected task	删除所选任务
Remove unsupported encodings from Accept-Encoding headers in incoming requests	从已接收请求的Accept-Encoding标头中删除不受支持的编码
Rename	重命名
Rename Project	重命名项目
Rename project	重命名项目
Repair project	修复项目
Repairing project, please wait ...	我们正在修理这个项目，请稍等......
Reparse	重解析
Repeat	重复
Repeat every:	以指定的间隔重复：
Repeat request in browser	用浏览器重新发送请求
Repeat the automatic parameter analysis on the current macro items	使用当前宏项重复自动参数分析
Replace	替换
Replace base parameter value	替换原始参数值
Replace current state	替换当前状态
Replace with encodings of:	替换编码为：
Replace with:	替换:
Replace:	替换:
Report bug	报告Bug
Report completed	报告完成
Report issue	报告问题
Report issues	报告问题
Report issues for selected branches	报告所选分支上的问题
Report issues for this branch	报告此分支问题
Report issues for this host	举报此主机问题
Report selected issues	报告所选问题
Report title	报告标题
Request	请求
Request Engine	请求引擎
Request Header	请求头部
Request Headers	请求头部
Request Matching	请求匹配
Request body	请求主体
Request count:	请求数量：
Request first line	请求首行
Request handling	请求处理
Request header	请求头部
Request headers	请求头部
Request in browser	通过浏览器请求
Request item again	重新请求项目
Request items again	重新请求项目
Request map 1 again in a different session context (configured in Options / Sessions)	使用不同的会话上下文再次请求映射1（在选项/会话中设置）
Request param name	请求参数名称
Request param value	请求参数值
Request the root of all directories	请求所有目录的root
Request to Collaborator	到Collaborator的请求
Request to:	请求：
Requests	请求
Requests handled	处理请求
Requests made:	生成的请求：
Requests queued:	请求队列：
Requests:	请求：
Requires Burp Suite Professional	需要Burp Suite专业版
Resource	资源
Resource Pool	资源池
Resource pool	资源池
Resource pools	资源池
Response	响应
Response Comparison	响应比较
Response Modification	响应修改
Response completed	响应完成
Response diffing	响应差异
Response from Collaborator	来自Collaborator的响应
Response header	响应头部
Response headers	响应头部
Response received	接收到的响应
Response to this request	此请求的响应
Responses	响应
Responses processed:	处理响应：
Responses queued for analysis:	响应分析队列：
Responses queued:	响应队列：
Restore completed	恢复完成
Restore defaults	恢复默认值
Restore legacy state file	旧状态文件恢复
Restore original value	恢复原始值
Restore setting from when Burp was last closed	恢复到上一次退出时的状态
Restore state	状态恢复
Restore state wizard	状态恢复向导
Restoring site map - please wait...	恢复站点地图 - 请稍候...
Restrict to requests containing these parameters:	限制包含这些参数的请求：
Results	结果
Results Tab	结果标签
Results table	结果表
Resume	恢复
Resume active scanning	恢复主动扫描
Resume scanner	恢复扫描
Resume spidering	恢复蜘蛛爬行
Resume task execution engine	恢复任务执行引擎
Resume task processing	恢复任务处理
Retest macro	重新测试宏
Retrying failed requests. Estimating time remaining...	重试失败的请求，评估剩余时间...
Reverse substring	反向子字符串
Revert	还原
Revert changes	还原更改
Revert to the original list of items	还原原始项目列表
Review the items you have selected for scanning. Double-click items to view full details. You can remove individual items which you do not wish to scan, or go back to modify your general filters.	请检查您选择扫描的项目。双击该项目以查看详细信息。您可以排除不想扫描的单个项目，也可以返回并更改通用过滤器。
Ruby Environment	Ruby环境
Rule	规则
Rule Actions	规则动作
Rule Description	规则描述
Run a macro	运行宏
Run a post-request macro	请求后执行宏
Run health check ...	健康检查执行......
Run macro:	执行宏：
Run the macro again	重新执行宏
Run the macro to test the handling of parameters	执行宏以测试参数处理
Running	正在运行
Running tasks	运行任务
Runtime file	运行文件(Runtime file)
SOCKS Proxy	SOCKS代理
SOCKS proxy host:	SOCKS代理主机：
SOCKS proxy port:	SOCKS代理端口：
SQL Server specific	SQL Server固有
SSI injection	SSI注入
SSL Ciphers	SSL Ciphers加密
SSL Negotiation	SSL协商
SSL Negotiation Workarounds	SSL协商的解决方法
SSL Pass Through	SSL 穿透
SSL Protocol	SSL协议
SSL Protocols	SSL协议
Sample	样本
Save	保存
Save Burp Collaborator server options	保存Burp Collaborator服务器选项
Save Burp Extender options	保存Burp Extender选项
Save HTML rendering options	保存HTML呈现选项
Save HTTP message display options	保存HTTP消息显示选项
Save Java environment options	保存Java环境选项
Save Javadoc files	保存Javadoc文件
Save Python environment options	保存Python环境选项
Save Ruby environment options	保存Ruby环境选项
Save SOCKS proxy options	保存SOCKS代理选项
Save SSL negotiation options	保存SSL协商选项
Save SSL negotiation workarounds options	保存SSL协商解决方法选项
Save SSL passthrough options	保存SSL传递选项
Save active scanning areas options	保存活动扫描选项
Save active scanning engine options	保存活动扫描引擎选项
Save active scanning optimizati onoptions	保存活动扫描优化选项
Save active scanning optimization options	保存活动扫描优化选项
Save application login options	保存应用程序登录选项
Save attack config	保存攻击设置
Save attack insertion points options	保存攻击插入点选项
Save attack results options	保存攻击结果选项
Save automatic project backup options	保存自动项目备份选项
Save cancelled	保存已取消
Save character set options	保存字符集选项
Save client SSL certificates options	保存客户端SSL证书选项
Save completed	保存完成
Save cookie jar options	保存cookie jar选项
Save copy	保存副本
Save copy of project	保存项目的副本
Save crawler options	保存抓取模块选项
Save encrypted using master password	使用主密码加密并保存
Save encrypted using master password:	使用主密码加密并保存：
Save entire history	保存输入历史记录
Save extract grep options	保存提取的grep选项
Save form submission options	保存表单提交选项
Save header row	保存头部行
Save hostname resolution options	保存主机名解析选项
Save hotkey options	保存热键选项
Save in clear text	以明文保存
Save in-scope items only	仅在范围内保存项目
Save intercept WebSockets messages options	保存WebSocket消息的拦截选项
Save intercept client requests options	保存客户端请求的拦截选项
Save intercept server responses options	保存服务器响应拦截选项
Save interface files	保存接口文件
Save item	保存项目
Save items	保存项目
Save legacy state file	保存旧状态文件
Save live active scanning options	保存实时活动扫描选项
Save live capture options	保存实时捕获选项
Save live passive scanning options	保存实时被动扫描选项
Save logging options	保存日志选项
Save macros options	保存宏选项
Save match and replace options	保存搜索和替换选项
Save match grep options	保存匹配grep选项
Save miscellaneous proxy options	保存其他代理选项
Save miscellaneous proxy settings options	保存其他代理配置选项
Save options	保存选项
Save out-of-scope requests options	保存范围请求选项
Save passive scanning areas options	保存被动扫描选项
Save passive spidering options	保存被动蜘蛛选项
Save paySaves grep options	保存有效载荷grep选项
Save performance feedback options	保存性能反馈选项
Save platform authentication options	保存平台认证选项
Save project options	保存项目选项
Save proxy history logging options	保存代理历史日志选项
Save proxy interception options	保存代理拦截选项
Save proxy listeners options	保存代理侦听器选项
Save redirections options	保存重定向选项
Save report	保存报告
Save request engine options	保存请求引擎选项
Save request headers options	保存请求标头选项
Save response modification options	保存响应操作选项
Save rest api options	保存REST API选项
Save results table	保存结果表
Save scan issue options	保存扫描项目选项
Save scheduled tasks options	保存计划任务选项
Save selected items	保存所选项目
Save server SSL certificates options	保存服务器SSL证书选项
Save session handling rules options	保存会话处理规则选项
Save spider scope options	保存蜘蛛范围选项
Save state	保存状态
Save state wizard	状态保存向导
Save static code analysis options	保存静态代码分析选项
Save status 100 responses options	状态100响应保存选项
Save streaming responses options	保存流媒体响应选项
Save target analysis report	保存目标分析报告
Save target scope options	保存目标范围选项
Save temporary files location options	保存临时文件位置选项
Save the display filter options	保存显示过滤器选项
Save timeouts options	保存超时选项
Save to file	保存到文件
Save to file:	保存到文件：
Save to library	保存到库
Save token analysis options	保存令牌分析选项
Save token handling options	保存令牌处理选项
Save tokens	保存令牌
Save upstream proxy servers options	保存更高级别的代理服务器选项
Save user interface options	保存用户界面选项
Save user options	保存用户选项
Saved preferences	保存的设置
Saving project	保存项目
Saving project...	保存项目......
Scan	扫描
Scan Configuration	扫描设置
Scan Issues	扫描问题
Scan Type	扫描类型
Scan accuracy:	扫描精度：
Scan again	重新扫描
Scan configuration	扫描设置
Scan defined insertion points	扫描定义的插入点
Scan details	扫描细节
Scan everything	全部扫描
Scan from a URL	从URL扫描
Scan next	扫描下一个
Scan queue	扫描队列
Scan queue help	扫描队列帮助
Scan speed:	扫描速度：
Scan type:	扫描类型：
Schedule task	计划任务
Scheduled Tasks	计划任务
Scope	范围
Scope:	适用范围：
Search	搜索
Search cancelled	搜索已取消
Search completed	搜索已完成
Search completed [dynamic search active]	搜索已完成[动态搜索启用]
Search options	搜索选项
Search responses for payload strings	搜索有效载荷字符串的响应
Search...	搜索...
See the documentation for more details on using Burp Clickbandit.	有关使用Burp Clickbandit的详细信息，请参阅文档。
Select BApp File	请选择BApp文件
Select Live Capture Request	选择实时捕获请求
Select a directory	目录选择
Select a directory containing custom payload lists	选择具有自定义有效载荷列表的目录
Select a file	选择文件
Select all	全选
Select bits to flip:	选择要反转的位：
Select by scan type:	按扫描类型选择：
Select configurations to control how the scan is carried out. You can select multiple configurations, and these will be applied in turn to determine the final configuration that is used for the scan. If no configurations are selected, then Burp Scanner's default settings will be used.	请选择控制扫描执行方法的设置。可以选择多个设置，按顺序应用这些设置，并确定最终用于扫描的设置。如果未选择任何设置，将使用Burp扫描仪的默认设置。
Select directory ...	选择目录......
Select directory for log file	选择日志文件目录
Select file ...	选择文件......
Select folder	选择文件夹
Select folder ...	选择文件夹...
Select folder to save file	选择要保存文件的文件夹
Select folder...	选择文件夹...
Select from library	从库中选择
Select generator ...	选择生成器......
Select how HTTP request messages should appear in the report.	选择如何在报告上放置HTTP请求消息。
Select how HTTP response messages should appear in the report.	选择如何在报告上放置HTTP响应消息。
Select individual issues:	选择个人问题：
Select license file	选择许可证文件
Select license key file ...	选择许可证密钥文件...
Select macro:	选择宏：
Select none	取消
Select payload generator	选择有效载荷生成器
Select processor:	选择处理器：
Select project file to import	选择要导入的项目文件
Select rule type	选择规则类型
Select the "extract grep" item from which to derive payloads:	选择“extract grep”项以获取有效载荷：
Select the certificate file	选择证书文件
Select the certificate to use. If no certificates are shown, or some details are missing, enter your PIN and click "Refresh". You can double-click on an item to view the full details of the certificate.	请选择要使用的证书。如果未显示证书，或者缺少某些详细信息，请输入PIN并单击“刷新”。双击该项以查看证书的详细信息。
Select the configuration that you would like to load for this project.	请选择要加载到此项目的设置。
Select the extension-provided payload generator that you want to use. Burp extensions can be loaded using the Extender tool.	请从生成有效内容的扩展中选择要使用的那个。扩展器可以读取Burp扩展。
Select the file containing the CA certificate to import.	请选择包含要导入的CA证书的文件。
Select the file containing the keystore to import, and the password for the keystore.	请选择包含要导入的密钥库的文件，然后输入密钥库密码。
Select the file containing the private key to import.	请选择包含要导入的密钥的文件。
Select the file from which to read payloads at runtime	选择文件以在运行时加载有效内容
Select the file where the report will be saved.	请选择一个文件来保存报告。
Select the folder where Burp Infiltrator should be saved:	请选择将保存Burp Infiltrator的文件夹：
Select the folder where the download will be saved.	请选择一个文件夹以保存下载的文件。
Select the folder where the new version of Burp will be saved.	请选择一个文件夹以保存新版本的Burp。
Select the input file from which Burp's state will be loaded.	请选择文件以阅读Burp的状态。
Select the items from the proxy history that you wish to include in the macro, and click "OK". Note that to record a macro now using your browser you will need to ensure that proxy interception is turned off.	请选择要包含在宏中的代理历史记录项，然后单击“确定”。请注意，为了立即使用浏览器记录宏，您需要确保关闭代理拦截。
Select the items on the basis of which Burp will match individual requests in one site map with requests in the other site map. The default settings will work effectively for most situations.	请选择一个项目以匹配每个站点地图的每个请求到Burp。在大多数情况下，它可以有效地使用默认设置。
Select the location in the response where the token appears.	请选择令牌在响应中显示的位置。
Select the name of the new project file.	请选择一个新的项目文件名。
Select the output file to which Burp's state will be saved.	请选择一个输出文件以保存Burp的状态文件。
Select the parameters to relocate within the request. Moving parameters can help to evade some filters, but results in many more scan requests.	请在请求中选择要重新排列的参数。您可以通过移动参数来避免某些过滤器，但会发生更多扫描请求。
Select the project file from which to load this site map.	请选择要加载到此站点地图中的项目文件。
Select the project file to import.	请选择要导入的项目文件。
Select the source to use for this site map.	请选择要用作此站点地图的输入。
Select the state file from which to load this site map.	请选择要加载到此站点地图中的状态文件。
Select the tools that this rule will be applied to.	请选择要应用规则的工具。
Select the tools whose traffic will be inspected to select items that are processed by the live scan.	请选择检查流量的工具，然后选择要在实时扫描中处理的项目。
Select the type of application that you want to instrument:	请选择要实例化的应用程序类型：
Select the type of task you want to run.	请选择要执行的任务类型。
Select the types of details to include in the report.	请选择要包含在报告中的详细信息。
Select the types of issues to include in the report.	请选择要包含在报告中的问题。
Select to use regular expression matching. Deselect to make matches literal.	选择它时搜索为正则表达式。取消选择时搜索为字符串。
Select whether items to be processed are deduplicated based on their URL and parameter names. Use this option to avoid scanning the same item more than once.	请根据URL和参数名称选择是否对要处理的项目进行重复数据删除。使用此选项，您不会多次扫描同一项目。
Selected	已选择
Selected file is a Burp state file	所选文件是Burp的状态文件
Selected generator:	选定的生成器
Selected rows	选定的行
Send requests here from other tools to configure a live capture. Select the request to use, configure the other options below, then click "Start live capture".	从其他工具发送实时捕获设置请求。请选择要使用的请求，设置其他选项，然后单击“开始实时捕获”。
Send to Comparer (request)	发送给对比器（请求）
Send to Comparer (requests)	发送给对比器（请求）
Send to Comparer (response)	发送给对比器（响应）
Send to Comparer (responses)	发送给对比器（响应）
Sensitive	敏感
September	9月
Sequential	顺序
Server SSL Certificates	服务器SSL证书
Server location:	服务器位置：
Server responses	服务器响应
Server-level issues	服务器级问题
Server-side code injection	服务器端代码注入
Server-side template breakout	服务器端模板操作
Server-side template injection (requires reflected XSS)	服务器端模板注入（需要反射型XSS）
Server-side variable names	服务器端变量名称
Service URL:	服务URL：
Service running	服务运行中
Session Handling Rules	会话处理规则
Session handling rule editor	会话处理规则编辑器
Session handling tracer	会话处理跟踪器
Session handling tracer [paused]	会话处理跟踪器[停止]
Session handling tracer help	会话处理跟踪器帮助
Session is not running	会话并未运行
Session is running	会话正在运行
Sessions	会话
Set "Connection close" on incoming requests	将“连接关闭”设置为接收请求
Set Connection: close	设置连接：关闭
Set a specific cookie or parameter value	设置指定的cookie和参数值
Set confidence	设置信任级别
Set response header "Connection: close"	响应标头中设置了“连接：关闭”
Set severity	设定风险等级
Set the details by pasting a URL	粘贴URL并设置详细信息
Set unmatched fields to:	为非匹配字段设置的值：
Settings	设定
Severity	风险
Short words	简短的话
Shortest:	最短:
Show all	全部显示
Show all differences between the two responses	2显示响应中的所有差异
Show details	查看详情
Show full documentation	查看完整文档
Show full help	显示所有帮助
Show in UI	在UI中显示
Show issue definition	显示问题定义
Show new history window	显示新的历史窗口
Show new site map window	在新窗口中显示站点地图
Show only commented items	仅显示已评论的项目
Show only highlighted items	仅显示彩色项目
Show only in-scope items	仅在范围内显示项目
Show only parameterized requests	仅显示带参数的请求
Show only requested items	仅显示请求的项目
Show only:	表示:
Show progress dialog during backups	备份期间显示进度对话框
Show response in browser	在浏览器中显示响应
Show this dialog during backups	备份期间显示此对话框
Showing all items	显示所有项目
Showing selected items	显示所选项目
Showing selected items 	显示所选项目
Shut down Burp and launch downloaded file	关闭Burp并启动下载的文件
Shut down Burp and run new version	关闭Burp并开始新版本
Significance Levels	重要性级别
Simple list	简单清单(Simple list)
Simple string	简单的字符串
Simulate manual testing	模拟手动测试
Simulation running	模拟执行
Site map	站点地图
Site map documentation	站点地图文档
Site map help	站点地图帮助
Size	大小
Skip all tests for these parameters:	跳过这些参数的所有测试：
Skip checks unlikely to be effective due to insertion point's base value	跳过检查不太可能受影响的插入点的原始值
Skip if matches regex	如果匹配正则表达式，请跳过
Skip server-side injection tests for these parameters:	跳过这些参数的服务器端注入测试：
Slot	插槽
Smart decode	智能解码
Sniper	狙击手（Sniper）
Some items could not be cleaned up.	某些项目无法删除。
Some macros are being used by session handling rules and cannot be deleted.	某些宏无法删除，因为它们用于会话处理规则。
Some of the specified URLs to scan are out of scope.	为扫描指定的部分URL超出范围。
Some of these items are outside the current spidering scope. Would you like to modify the scope to include the items?	其中一些项目超出了当前的访问范围。是否要修改范围以包含此项？
Some of these items are outside the current target scope. Are you sure you want to perform an active scan?	其中一些项目超出了当前范围。您确定要执行主动扫描吗？
Some passwords were encrypted using a different master password. Please enter the master password for the following configuration.	某些密码使用另一个主密码加密。请输入以下设置的主密码。
Source	源
Source:	源：
Specific address:	指定地址：
Specific string:	指定文字列:
Specify a prefix for URLs you want to match.	请指定您要匹配的网址的前缀。
Specify a regular expression to match each URL component, or leave blank to match any item. An IP range can be specified instead of a hostname.	指定要匹配每个URL的正则表达式，或将其留空以匹配任何项目。您可以指定IP范围而不是主机名。
Specify the account credentials that should be submitted to any login functions. The crawler will use these to discover authenticated content behind login functions.	请指定要发送到登录功能的帐户凭据。爬行程序使用这些来在登录身份验证后检测内容。
Specify the details of the form field completion rule.	请指定表单字段完成规则详细信息。
Specify the details of the interception rule.	请指定拦截规则的详细信息。
Specify the details of the match/replace rule.	请指定搜索和替换规则详细信息。
Specify the details of the server to which the request will be sent.	请指定发送请求的服务器的详细信息。
Specify the host and port details for the target, or leave blank to match any item. An IP range can be specified instead of a hostname.	请将其留空以指定目标主机和端口详细信息或匹配任何项目。您可以指定IP范围而不是主机名。
Specify the host(s) for which the certificate should be used, and the certificate type. You can use wildcards to specify destination hosts (* matches zero or more characters, ? matches any character except a dot), or leave the field blank to apply to all hosts.	选择使用证书的主机及其证书类型。您可以使用通配符（*表示零个或多个字母，？对于除dot之外的任何字符）指定目标主机，或将其留空以应用于所有主机。
Specify the items to include in this site map. If you want to re-request the site map in a different session context, you should restrict to in-scope items and also ensure that the defined scope excludes any requests that modify that context, including login and logout.	请指定要包含在此站点地图中的项目。如果要在不同的会话上下文中重新请求站点地图，请将其限制为作用域中的项目，并确保更改上下文的请求（包括登录和注销）超出范围。
Specify the options for re-requesting the site map. Ensure you have configured suitable session handling rules for the target tool, in Options / Sessions. These rules will be applied to requests when re-requesting the site map.	请指定重新申请Sitemap的选项。在选项/会话中，请确保正确设置目标工具的会话处理规则。这些规则适用于重新访问Sitemap的请求。
Specify the resource pool in which the scan will be run. Resource pools are used to manage the usage of system resources across multiple tasks.	请指定要扫描的资源池。资源池用于管理跨多个任务的系统资源使用情况。
Specify the title and structure to use in the report.	请指定要在报告中使用的标题和结构。
Spectral	光谱
Spectral Analysis - Significance Levels	光谱分析 - 显着性水平
Spectral tests	光谱测试
Spider Engine	蜘蛛引擎
Spider Scope	蜘蛛范围
Spider Status	蜘蛛状态
Spider from a URL	从URL运行蜘蛛
Spider from discovered content	从发现的内容运行蜘蛛
Spider from here	从这里运行蜘蛛
Spider is paused	蜘蛛已暂停
Spider is running	蜘蛛正在运行中
Spider requests queued:	使用蜘蛛爬行请求队列：
Spider selected items	使用蜘蛛爬行所选项目
Spider this branch	使用蜘蛛爬行这个分支
Spider this host	使用蜘蛛爬行这个主机
Standard Error	标准错误
Standard Output	标准输出
Start	开始
Start Burp	进入Burp
Start after expression:	从表达式开始：
Start at offset:	在偏移处开始：
Start at:	开始时间:
Start attack	开始攻击
Start directory:	开始目录：
Start live capture	开始实时捕捉
Start time	开始时间
Start time:	开始时间:
Starting project, please wait ...	项目正在开始，请稍候......
Static Code Analysis	静态代码分析
Static URLs	静态URL
Static analysis	静态解析
Static code analysis	静态代码分析
Status	状态
Status 100 Responses	状态 100 响应
Status code	状态代码
Step:	步长：
Stop	停止
Stop at maximum:	达到最大数量时停止：
Stop if duplicate payload found	检测到重复有效载荷时停止
Stop sending out-of-scope items to Proxy history and other Burp tools	停止将未经过处理的项目发送到代理历史记录或其他Burp工具
Store full payloads	保存所有有效载荷
Store requests	保存请求
Store responses	保存响应
Store streaming responses (may result in large temp files)	保存流式响应（可以创建大型临时文件）
Stored DOM issues	存储型DOM的问题
Stored XSS	存储型XSS
Streaming Responses	流式响应
Streaming response [double-click to cancel]	流式响应[双击取消]
Streaming response [not stored]	流式响应[未保存]
String echo	文字列表示
Strip Accept-Encoding headers in incoming requests	从收到的请求中删除Accept-Encoding标头
Strip Proxy-* headers in incoming requests	从收到的请求中删除Proxy- *标头
Strip Sec-WebSocket-Extensions headers in incoming requests	从传入请求中删除Sec-WebSocket-Extensions标头
Strip chunked encoding metadata in streaming responses	从流响应中删除分块编码元数据
Subject	主题
Submit BApp rating	BApp评级传输
Submit anonymous feedback about Burp's performance	匿名发送Burp的表现
Submit form	表格提交
Submit rating	发送评级
Substring	部分文字列
Success	成功
Suffix:	后缀：
Suite options	套房选择
Suite scope	总体范围
Summary	汇总
Summary bar chart	汇总条形图
Summary table	汇总表
Support Center	支持中心
Support invisible proxying (enable only if needed)	支持透明代理（仅在必要时启用）
Suppress Burp error messages in browser	抑制浏览器的Burp错误消息
Suspicious input transformation	可疑的输入值转换
Sync selection	同步选择
Sync views	同步显示
Tab	标签
Table of contents levels	内容级别表
Tabs	标签
Take full ownership of the project	获得项目的完全所有权
Target Scope	目标范围
Target: Not specified	目标：未指定
Task	任务
Task Type	任务类型
Task auto-start	自动任务启动
Task details	任务细节
Task execution is paused	任务执行已暂停
Task execution settings	任务执行设置
Tasks	任务
Tasks queued:	任务队列：
Temporary Files Location	临时文件位置
Temporary files	临时文件
Temporary project	临时项目
Tentative	暂定
Terms and Conditions	条款和条件
Test Description	测试描述
Test all extensions observed in use on target site, except for:	测试目标站点中使用的所有扩展，但以下内容除外：
Test file stems with no extension	文件名没有扩展名
Test in browser	用浏览器测试
Test macro	测试宏
Test these extensions:	测试以下扩展名：
Test these variant extensions on discovered files:	在找到的文件上测试这些扩展名：
Testing macro:	正在测试的宏：
The BApp Store contains Burp extensions that have been written by users of Burp Suite, to extend Burp's capabilities.	BApp商店扩展了扩展Burp功能，由Burp Suite用户编写。
The Community Edition of Burp Suite contains a demo version of Burp Intruder. Some functionality is disabled, and attacks are time throttled.	Burp Suite的社区版本包含Burp 攻击器的演示版本。某些功能已被禁用，攻击会定时。
The REST API can be used by other tools to integrate with Burp Suite. This function exposes sensitive functionality and data, and you should read the full documentation before enabling the service.	您可以使用REST API将Burp Suite与其他工具集成。此功能公开高度机密的功能和数据，因此您需要在启用服务之前阅读所有手册。
The actions below will be performed in sequence when this rule is applied to a request.	此规则按顺序执行并应用于请求。
The certificate and private key were successfully exported.	证书和私钥已成功导出。
The certificate and private key were successfully imported.	证书和私钥已成功导入。
The certificate was loaded successfully.	证书成功加载。
The certificate was successfully exported.	证书成功导出。
The chart indicates the degree of confidence in the randomness of the sample at each bit position. The significance level at each position is the probability of the observed bit-level results occurring, assuming that the sample is randomly generated.	该图显示了每个位位置处样本随机性的可靠性。假设样本是随机生成的，每个位置的显着性水平是观察到的位级别的发生概率。
The chart indicates the degree of confidence in the randomness of the sample at each character position. The significance level at each position is the probability of the observed character-level results occurring, assuming that the sample is randomly generated.	该图显示了每个字符位置的样本随机性的可靠性。假设样本是随机生成的，每个位置的显着性水平是观察到的字符水平的发生概率。
The chart shows the number of bits contributed by each character position.	在图中，显示了每个字符位置贡献的位数。
The chart shows the number of bits of effective entropy at each significance level, based on all tests. Each significance level defines a minimum probability of the observed results occurring if the sample is randomly generated. When the probability of the observed results occurring falls below this level, the hypothesis that the sample is randomly generated is rejected. Using a lower significance level means that stronger evidence is required to reject the hypothesis that the sample is random, and so increases the chance that non-random data will be treated as random.	该图显示了基于所有测试的每个显着性水平的有效熵位的数量。每个显着性水平定义了随机生成样本时发生的观察的最小概率。如果观察概率低于该水平，则否定样本随机生成的假设。降低显着性水平将需要更强的证据来否定令牌随机生成的假设，增加了随机数据被视为随机数据的可能性。
The chart shows the number of bits of effective entropy at each significance level, based on the bit-level tests. Each significance level defines a minimum probability of the observed results occurring if the sample is randomly generated. When the probability of the observed results occurring falls below this level, the hypothesis that the sample is randomly generated is rejected. Using a lower significance level means that stronger evidence is required to reject the hypothesis that the sample is random, and so increases the chance that non-random data will be treated as random.	该图显示了基于比特级测试的每个显着性水平的有效熵比特数。每个显着性水平定义了随机生成样本时发生的观察的最小概率。如果观察概率低于该水平，则否定样本随机生成的假设。降低显着性水平将需要更强的证据来否定令牌随机生成的假设，增加了随机数据被视为随机数据的可能性。
The chart shows the number of bits of effective entropy at each significance level, based on the character-level tests. Each significance level defines a minimum probability of the observed results occurring if the sample is randomly generated. When the probability of the observed results occurring falls below this level, the hypothesis that the sample is randomly generated is rejected. Using a lower significance level means that stronger evidence is required to reject the hypothesis that the sample is random, and so increases the chance that non-random data will be treated as random.	该图显示了基于字符级别测试的每个显着性级别的有效熵位数。每个显着性水平定义了随机生成样本时发生的观察的最小概率。如果观察概率低于该水平，则否定样本随机生成的假设。降低显着性水平将需要更强的证据来否定令牌随机生成的假设，增加了随机数据被视为随机数据的可能性。
The chart shows the size of the character set used at each position. This number is the count of different characters that appear at each position within the sample data.	该图显示了每个位置使用的字符集的大小。此数字是样本数据中每个位置出现的不同字符的数量。
The configuration library lets you manage different Burp configurations for particular tasks. There are various built-in configurations that are useful for common purposes, and you can create your own configurations as required.	使用配置库，您可以根据任务管理各种Burp设置。有各种内置设置可用于一般用途，您可以根据需要创建唯一设置。
The data recovery process completed successfully. You can now open the recovered project.	数据恢复过程已成功完成。您可以打开已恢复的项目。
The directory selected is not empty	所选目录不为空
The export operation encountered some problems.	导出过程出现问题。
The extension could not be loaded because it requires a later version of Java. To use this extension you will need to start Burp with the required or later Java version.	我们无法加载，因为扩展程序请求更新版本的Java。要使用此扩展，请在所请求的版本或更新版本的Java中启动Burp。
The extension is loading.	加载扩展。
The extension loaded successfully. Any output or error messages generated are shown below.	已成功加载扩展程序。生成的输出和错误显示在下面。
The file does not contain JSON	该文件没有JSON
The file you have selected is a Burp state file, not a project file.	所选文件不是项目文件，而是Burp的状态文件。
The final response from the macro	宏的最后响应
The following configurations could not be exported due to an error:	由于错误，我们无法导出以下设置：
The following items will be removed:	删除以下项目：
The following rules determine whether Burp sends each outgoing request to a proxy server, or directly to the destination web server. The first rule that matches each destination host will be used. To send all traffic to a single proxy server, create a rule with * as the destination host.	每个传出请求是发送到代理服务器还是直接发送到目标Wweb服务器由以下规则确定。使用目标主机首次匹配的规则。要将所有流量发送到单个代理服务器，请使用目标主机*创建规则。
The free edition of Burp contains a demo version of Burp Intruder. Some functionality is disabled, and attacks are time throttled.	Burp的免费版本包含Burp 攻击器的演示版本。某些功能已被禁用，攻击会定时。
The item itself	项目本身
The macro contains no items. Are you sure you want to proceed?	宏中没有项目。你确定要继续吗？
The name is already used	该名称已被使用
The options below control the types of analysis that is performed at the bit level.	控制在位级执行的分析类型。
The options below control the types of analysis that is performed at the character level.	控制在角色级别执行的分析类型。
The overall bit counts for effective entropy have been adjusted to reflect this compression.	已调整有意义熵的总位数以反映此压缩。
The private key was successfully exported.	私钥成功导出。
The project file contains no importable data.	没有可以在项目文件中导入的数据。
The project file was successfully repaired. You can now open the repaired project.	项目文件已成功修复。打开已恢复的项目。
The request has not yet been issued - click "Fetch response" to issue it	该请求尚未发布 - 请单击“获取响应”并发出
The response from the current request, issued prior to the macro	宏之前发出的当前请求的响应
The rule contains no actions.	此规则中没有任何操作。
The selected file does not appear to be a Burp project file and cannot be opened.	我无法打开它，因为看起来所选文件不是Burp项目文件。
The selected file is the current Burp project. Please select another file.	所选文件是当前的Burp项目。请选择其他文件。
The selected file is the current project file	所选文件是当前项目
The selected item is not a directory	所选项目不是目录
The selected project file appears to be corrupt and cannot be opened.	所选项目已损坏，无法打开。
The supplied license key was not recognized. Please try re-entering your license key.	我们无法识别许可证密钥。请重新输入许可证密钥。
There appears to be a copy of Burp Infiltrator in the selected folder. Do you want to overwrite it?	所选文件夹中有一个Burp Infiltrator的副本。你想覆盖它吗？
Therefore some bits may record a significance level that is below the FIPS pass level even though they do not strictly fail the FIPS test.	因此，某些位可能低于FIPS通过级别，尽管它们不会通过严格的FIPS测试。
These settings are configured within user options but can be overridden here for this specific project.	可以使用用户选项设置这些设置，但您可以使用指定的项目覆盖此设置。
These settings are undocumented and are not intended for general use. Any changes may have unpredictable results and break the crawler. We recommend that you only modify these settings based on advice from PortSwigger support.	这些设置未记录在案，不适用于一般用途。这样做可能会导致意外结果，这可能会导致爬虫损坏。我们建议仅根据PortSwigger支持建议更改这些设置。
These settings are used to automatically replace parts of requests and responses passing through the Proxy.	这是一个自动替换通过代理的部分请求或响应的设置。
These settings are used to perform automatic modification of responses.	设置自动响应更改。
These settings are used to specify URLs returning responses that stream indefinitely. The Proxy will pass these responses straight through to the client. Repeater will update the response panel as the response is received. Other tools will ignore streaming responses. In order to view the contents of streaming responses within Burp, you need to check the "store streaming responses" option.	指定返回无限流响应的URL。代理将这些响应直接传递给客户端。 重放器将在收到响应后更新面板。其他工具忽略流式响应。要查看Burp中的流式响应内容，您需要选中“保存流式响应”选项。
These settings are used to specify destination web servers for which Burp will directly pass through SSL connections. No details about requests or responses made via these connections will be available in the Proxy intercept view or history.	指定目标Web服务器以直接传递SSL连接。这些连接生成的请求和响应的详细信息无法显示在代理拦截或历史记录中。
These settings can be used to enable certain SSL features that might be needed to successfully connect to some servers.	它是一个设置，用于启用与某些服务器的正常连接所需的各种SSL功能。
These settings can be used to extract useful information from responses into the attack results table.	我们从响应中提取有用信息并将其显示在攻击结果列表中。
These settings can be used to flag result items containing reflections of the submitted payload.	您可以在结果项上设置标记，以反映传输的有效载荷。
These settings can be used to flag result items containing specified expressions.	它是一个设置，为结果设置一个标志，包括指定的正则表达式。
These settings control how Burp binds the REST API.	控制REST API的绑定方法。
These settings control how Burp binds the proxy listener.	控制绑定代理侦听器的方式。
These settings control how Burp handles application errors (connection failures and transmission timeouts) that arise during the audit phase of the scan.	控制如何处理扫描审计阶段发生的应用程序错误（如连接错误和传输超时）。
These settings control how Burp handles application errors (connection failures and transmission timeouts) that arise during the crawl phase of the scan.	它控制在扫描爬行阶段如何处理应用程序错误（例如连接错误和传输超时）。
These settings control how Burp handles different character sets when displaying raw HTTP messages. Note that some glyphs are not supported by all fonts. If you need to use an extended or unusual character set, you should first try a system font such as Courier New or Dialog.	控制在显示HTTP消息raw时Burp如何处理各种字符集。请注意，所有字体都不支持某些字形。如果要使用扩展或异常字符集，请首先尝试使用Courier New和Dialog等系统字体。
These settings control how Burp handles extensions on startup.	设置如何在启动时处理扩展。
These settings control how Burp handles in-tool rendering of HTML content.	在工具中设置HTML内容的呈现。
These settings control how Burp handles redirections when performing attacks.	控制执行攻击时如何处理重定向。
These settings control how the Spider submits login forms.	设置Spider如何发送登录表单。
These settings control how the crawler will interact with any login functionality, aside from any application logins that are explicitly configured for the crawl.	除了为抓取显式设置的应用程序登录之外，您还可以控制使用登录功能执行的处理类型。
These settings control how the discovery session adds file extensions to file stems that are being tested.	在搜索会话中，控制如何将文件扩展名添加到文件名主体并进行测试。
These settings control how tokens are handled during analysis.	设置如何处理正在分析的标记。
These settings control logging of HTTP requests and responses.	控制HTTP请求和响应的日志记录。
These settings control some specific details of Burp Proxy's behavior. You can change the default settings here to deal with particular problems or situations.	这是一个控制Burp Proxy详细操作的设置。您可以更改默认设置以解决特定问题和情况。
These settings control the SSL protocols and ciphers that Burp will use when performing SSL negotiation with upstream servers. If you are experiencing problems with SSL negotiation, you can use these settings to request use of specific protocols or ciphers. Use these options with caution as misconfiguration may break all your outgoing SSL connections.	控制Burp用于与更高级别服务器执行SSL协商的SSL协议和密码。如果您遇到SSL协商问题，可以将其配置为使用特定协议和密码。配置错误可能会导致所有传出的SSL连接中断，因此请谨慎使用。
These settings control the behavior of Burp Scanner's JavaScript analysis.	控制Burp Scanner JavaScript解析的行为。
These settings control the engine used for making HTTP requests and harvesting tokens when performing the live capture.	配置引擎的行为以在执行实时捕获和收集令牌时生成HTTP请求。
These settings control the engine used for making HTTP requests when discovering content.	设置搜索内容时用于创建HTTP请求的引擎。
These settings control the engine used for making HTTP requests when doing active scanning.	设置在主动扫描期间生成HTTP请求的引擎的行为。
These settings control the engine used for making HTTP requests when performing attacks.	控制在攻击执行期间用于创建HTTP请求的引擎。
These settings control the engine used for making HTTP requests when spidering.	设置在巡逻期间生成HTTP请求的引擎的行为。
These settings control the request headers used in HTTP requests made by the Spider.	控制Spider生成的HTTP请求的标头。
These settings control the server SSL certificate that is presented to SSL clients.	控制提交给SSL客户端的SSL服务器证书。
These settings control the types of checks performed during active scanning.	设置在主动扫描期间要检查的类型。
These settings control the types of checks performed during passive scanning.	设置被动扫描期间要检查的类型。
These settings control the types of redirections that Burp will understand in situations where it is configured to follow redirections.	将Burp识别的重定向类型设置为遵循重定向的情况。
These settings control the types of scanning that will include static analysis of executable code. Note that static analysis can consume large amounts of memory and processing, and so it may be desirable to restrict static analysis to key targets of interest.	这是一种扫描类型设置，可执行可执行代码的静态分析。请注意，静态分析使用大量内存和处理器，因此需要执行仅限于有趣的主题。
These settings control the way Burp handles HTTP responses with status 100.	控制Burp如何处理状态为100的HTTP响应。
These settings control the way the Spider crawls for basic web content.	控制Web内容的基本爬行方法。
These settings control what information is captured in attack results.	设置要在攻击结果中捕获的信息。
These settings control whether Burp redirects requests received by this listener.	控制侦听器如何重定向收到的请求。
These settings control whether Intruder updates the configured request headers during attacks.	控制攻击器是否在攻击期间更新已配置的请求标头。
These settings control whether and how the Spider submits HTML forms.	这些设置控制Spider如何发送HTML表单。
These settings control whether insertion points are created within nested data structures, and the maximum number of insertion points to create per request that is audited.	控制是否在嵌套数据结构中创建插入点，以及为每个要审计的请求创建的最大插入点数。
These settings control which issues Burp will check for. You can select issues by scan type or individually. If you select individual issues, you can also select the detection methods that are used for some types of issues.	设置要由Burp检查的项目。您可以选择扫描项目类型，也可以单独选择。选择单个项目时，某些项目也可以选择要使用的检测方法。
These settings determine whether Burp sends each outgoing request to a proxy server, or directly to the destination web server. The first rule that matches each destination host will be used. To send all traffic to a single proxy server, create a rule with * as the destination host.	设置是通过代理服务器还是直接向Web服务器发送传出请求。使用目标主机首次匹配的规则。要将所有流量发送到单个代理服务器，请使用目标主机*创建规则。
These settings let you configure Burp to use a SOCKS proxy. This setting is applied at the TCP level, and all outbound requests will be sent via this proxy. If you have configured rules for upstream HTTP proxy servers, then requests to upstream proxies will be sent via the SOCKS proxy configured here.	配置为使用SOCKS代理。此设置应用于TCP级别，所有传出请求都通过此代理发送。如果已设置更高级别的HTTP代理服务器，则将通过此处的SOCKS代理集发送对上层代理的请求。
These settings let you configure hotkeys for common actions. These include item-specific actions such as "Send to Repeater", global actions such as "Switch to Proxy", and in-editor actions such as "Cut" and "Undo".	您可以设置热键以执行常见操作。您可以为特定于项目的操作设置热键，例如“发送到转发器”，诸如“切换到代理”之类的全局操作，编辑器中的操作，如“剪切”和“撤消”。
These settings let you configure the client SSL certificates that Burp will use when a destination host requests one. Burp will use the first certificate in the list whose host configuration matches the name of the host being contacted. You can double-click on an item to view the full details of the certificate.	设置目标主机请求客户端SSL证书时使用的证书。使用列表中与您尝试连接的主机的主机名匹配的第一个证书。双击该项以查看证书的详细信息。
These settings let you configure the environment for executing extensions that are written in Java. If your extensions use any libraries, you can specify a folder from which libraries will be loaded.	您可以设置环境以执行用Java编写的扩展。如果扩展使用任何库，则可以指定将加载库的文件夹。
These settings let you configure the environment for executing extensions that are written in Python. To use Python extensions, you will need to download Jython, which is a Python interpreter implemented in Java.	您可以设置环境以执行用Python编写的扩展。要使用Python扩展，您需要下载Jython，一个用Java实现的Python解释器。
These settings let you configure the environment for executing extensions that are written in Ruby. To use Ruby extensions, you will need to download JRuby, which is a Ruby interpreter implemented in Java. Note that you can either configure the location of the JRuby JAR file here, or you can load the JAR file on startup via the Java classpath.	您可以设置环境以执行Ruby扩展。要使用Ruby的扩展，您需要下载JRuby，一个用Java实现的Ruby解释器。您可以在此处设置JRuby JAR文件的位置，也可以在启动时从Java类路径加载JAR文件。
These settings let you control the appearance of Burp's user interface.	控制Burp用户界面的外观。
These settings let you control the behavior of the active scanning logic to reflect the objectives of the scan and the nature of the target application. See the detailed help for more information about each option.	根据扫描的目的和目标应用程序的性质，您可以控制主动扫描逻辑的行为。有关每个选项的详细信息，请参阅帮助。
These settings let you control the behavior of the audit logic to reflect the objectives of the audit and the nature of the target application. See the detailed help for more information about each option.	根据审计目的和目标应用程序的性质，您可以控制审计逻辑的行为。有关每个选项的详细信息，请参阅帮助。
These settings let you control the behavior of the crawl logic to reflect the objectives of the crawl and the nature of the application. See the detailed documentation for more information about each option.	根据审计目的和应用程序的性质，您可以控制爬行逻辑的行为。有关每个选项的详细信息，请参阅详细文档。
These settings let you specify tasks that Burp will perform automatically at defined times or intervals.	设置Burp在定义的时间或间隔自动执行的任务。
These settings specify the timeouts to be used for various network tasks. Values are in seconds. Set an option to zero or leave it blank to never timeout that task.	指定用于各种网络任务的超时。该值以秒为单位。如果您不希望任务超时，请将其设置为0或将其留空。
This URL is outside the current target scope. Are you sure you want to discover content?	此URL超出了当前范围的范围。您确定要搜索内容吗？
This action checks whether the session is valid, by either issuing the current request or running a predefined macro (sequence of requests), and inspecting the response. If the session is invalid, you can optionally perform a further action to obtain a new valid session.	此操作通过执行当前请求或定义的宏（请求序列）并检查响应来检查会话是否有效。如果会话无效，您可以执行详细操作以在必要时获取新的有效会话。
This action issues the current request and then runs a further macro (sequence of requests). No further rules or actions will be applied after this action.	此操作发出当前请求，然后执行更多宏（请求序列）。此操作后不会再执行任何规则或操作。
This action prompts you to recover a valid session using your browser (configured to connect via Burp Proxy). The cookies set by the application will be added to the session handling cookie jar, and can also be set in the current request.	此操作将打开一个提示，使用浏览器恢复有效会话（设置为通过Burp Proxy连接）。应用程序设置的cookie将添加到会话处理cookie jar中，并可以为当前请求设置。
This action runs a predefined macro (sequence of requests) and optionally updates parameters and cookies in the current request based on the result of the macro.	此操作执行预定义的宏（请求序列），并根据宏的结果根据需要更新当前请求的参数和cookie。
This action sets a specific value in a named request parameter or cookie.	此操作将指定值设置为请求参数和具有指定名称的cookie。
This action updates the request with the relevant cookies from the session handling cookie jar.	此操作使用会话处理cookie jar的关联cookie更新请求。
This applies to most network transfers	适用于大多数网络通信
This applies to responses that do not contain a Content-Length or Transfer-Encoding header	它适用于没有Content-Length或Transfer-Encoding标头的响应
This feature can be used to prevent Burp from issuing any out-of-scope requests, including those made via the proxy.	它可以防止由范围外的请求引起的问题，包括通过代理生成的请求。
This file already exists. Are you sure?	文件已存在。你确定吗？
This function allows you to load Sequencer with a sample of tokens that you have already obtained, and then perform the statistical analysis on the sample.	您可以将已获取的标记的样本加载到定序器中，然后执行样本的统计分析。
This function lets you do a word- or byte-level comparison between different data. You can load, paste, or send data here from other tools and then select the comparison you want to perform.	在不同数据之间进行字或字节级别比较。请阅读数据，粘贴数据，从其他工具发送，然后选择要运行的比较。
This function sends common test payloads to random URLs and parameters at irregular intervals, to generate traffic similar to that caused by manual penetration testing. Its only real use is to let you take a break from testing while still looking busy according to the server's logs. Only items which you selected in the site map will be requested.	此功能以不规则的间隔将通用测试有效载荷发送到随机URL和参数，以生成通过手动渗透测试发生的流量。使用此功能的唯一实用方法是在服务器上留下似乎正在测试的日志时休息一下。只会针对站点地图中选择的项目发送请求。
This is the timeout after which failed DNS lookups are repeated	重复失败的DNS名称解析是超时
This is the timeout after which successful DNS lookups expire	成功解析DNS名称的超时时间
This item is outside the current spidering scope. Would you like to modify the scope to include the item?	此项目超出当前访问范围。是否要修改范围以包含此项？
This item is outside the current target scope. Are you sure you want to perform an active scan?	此项目超出了当前范围。您确定要执行主动扫描吗？
This listing contains the definitions of all issues that can be detected by Burp Scanner.	Burp 扫面器模块可以检测到的所有问题的定义列表。
This macro is being used by a session handling rule and cannot be deleted.	无法删除此宏，因为它在会话处理规则中使用。
This panel shows a list of the unique SSL certificates received from web servers. Double-click an item to show the full details of the certificate.	此面板显示从Web服务器接收的唯一SSL证书。双击该项目以查看证书的详细信息。
This payload type can be used to generate illegal Unicode representations of characters. It is sometimes effective in bypassing filters designed to block certain characters. See the full help for details of each option.	使用非法Unicode表示法生成字符串。避免用于阻止特定字符的过滤器可能是有效的。有关每个选项的详细信息，请参阅帮助。
This payload type can be used to shuffle blocks of ciphertext in ECB-encrypted data, so as to meaningfully modify the decrypted cleartext and potentially interfere with application logic. You can optionally supply a list of encrypted strings that use the same cipher and key, to provide additional blocks for shuffling into the original data.	如果重新排列使用ECB加密的密文数据块，则在解密和应用程序逻辑变得不稳定时，它有可能成为有意义的明文。如有必要，您可以使用相同的加密和密钥指定加密字符串列表，并将其用作原始数据中的附加重组块。
This payload type copies the value of the current payload at another payload position. It can be used with attack types that have multiple payload sets.	此有效载荷类型将另一个有效载荷的值复制到当前有效载荷值。它可以与使用多个有效载荷集的攻击类型一起使用。
This payload type generates date payloads within a given range and in a specified format.	生成给定范围内指定格式的日期有效内容。
This payload type generates numeric payloads within a given range and in a specified format.	生成给定范围内指定格式的数字有效内容。
This payload type generates payloads based on blocks of a specified character or string. It can be useful for detecting buffer overflows and exploiting some logic flaws.	根据指定的字符或字符串块生成有效载荷。它对缓冲区溢出检测和逻辑流攻击很有用。
This payload type generates payloads of specified lengths that contain all permutations of a specified character set.	从指定的长度和字符集生成所有组合的有效载荷。
This payload type generates payloads whose value is an empty string. With no payload markers configured, this can be used to repeatedly issue the base request unmodified.	它生成一个有效载荷值为空的字符串。无需设置有效载荷标记，可以在不更改基本请求的情况下重复发送。
This payload type invokes a Burp extension to generate payloads.	执行Burp扩展以创建有效载荷。
This payload type lets you configure a file from which to read payload strings at runtime.	您可以将文件设置为在运行时加载有效载荷字符串。
This payload type lets you configure a list of names or email addresses, and derives potential usernames from these using various common schemes. You can enter items as "firstname lastname" or "firstname.lastname@example.org".	我们设置了一个名称和电子邮件地址列表，然后我们使用通用生产规则来生成各种潜在的用户名。您可以输入带有“名字姓氏”或“名字姓氏@ example.org”的项目。
This payload type lets you configure a list of strings and apply various case modifications to each item.	您可以设置字符串列表以及如何更改要应用于每个项目的案例。
This payload type lets you configure a list of strings and apply various character substitutions to each item.	您可以设置字符串列表和各种字符替换以应用于每个项目。
This payload type lets you configure a simple list of strings that are used as payloads.	设置用于有效内容的简单字符串列表。
This payload type lets you configure multiple lists of items, and generate payloads using all permutations of items in the lists.	您可以设置多个项目列表并组合列表中的所有项目以生成有效载荷。
This payload type lets you extract each payload from the response to the previous request in the attack. It is useful in some situations where you need to work recursively to extract useful data or deliver an exploit. Extract grep items can be defined in the Options tab.	此有效载荷类型从先前攻击请求的响应中提取有效载荷。在需要提取有用数据并递归提供漏洞利用的情况下，它非常有用。可以在“选项”选项卡中定义提取grep项目。
This payload type operates on a string input and modifies the value of each character position in turn. It is useful to quickly test which parts of a long string have an effect on the application's processing.	该有效载荷类型相对于输入字符串按顺序改变每个位置处的字符。快速测试长字符串的哪一部分会影响应用程序的处理非常有用。
This payload type operates on an input and modifies the value of each bit position in turn. It can sometimes be used to meaningfully modify the decrypted values of CBC-encrypted data, and potentially interfere with application logic.	该有效载荷类型相对于输入值顺序地改变每个比特位置的值。在某些情况下，您可以对CBC加密数据进行有意义的更改，或者可能会干扰应用程序逻辑。
This project file has been accessed by a more recent version of Burp. Some data may not be not be displayed or may be incomplete.	此项目文件正在访问更新版本的Burp。某些数据可能无法显示或不完整。
This setting can be used to URL-encode selected characters within the final payload, for safe transmission within HTTP requests.	为了安全地发送HTTP请求，这项设置可以在最终有效载荷中对指定字符进行URL编码。
This setting controls how Burp handles extensions on startup.	Burp控制启动时如何处理扩展。
This setting controls the state of proxy interception at startup.	启动时设置代理拦截状态。
This setting controls whether adding items to Target scope will automatically set the Proxy option to stop sending out-of-scope items to the history or other Burp tools.	设置是否自动添加“代理”选项，以防止在向目标范围添加项目时将超出范围的项目发送到历史记录或其他Burp工具。
This strategy applies some optimizations to the coverage of the crawl, with some loss of speed in some applications. It is appropriate for applications with volatile or overloaded URLs, or more complex stateful functionality than normal.	此策略对爬行的覆盖范围应用了一些优化，但在某些应用程序中，速度会丢失。它适用于具有易失性或重载URL的应用程序或具有比平常更复杂的有状态功能的应用程序。
This strategy applies some optimizations to the speed of the crawl, with some loss of coverage in some applications. It is appropriate for applications that use mostly stable and unique URLs, and only limited or simple stateful functionality.	此策略对爬行速度应用了一些优化，但在某些应用程序中丢失了穷举。它适用于大多数都是独特且稳定的情况，并且只有有限或简单的有状态功能。
This strategy optimizes as far as possible for the coverage of the crawl, at the expense of speed in most applications. Is is appropriate to achieve strong coverage of applications with highly volatile or overloaded URLs or heavily complex stateful functionality.	此策略尽可能优化爬行覆盖率，但在大多数应用程序中减慢速度。它适用于强烈覆盖高度易变的URL，负载很重的URL和非常复杂的有状态函数。
This strategy optimizes as far as possible for the speed of the crawl, at the expense of lower coverage in many applications. Is is appropriate for applications with stable and unique URLs, and no stateful functionality.	此策略尽可能优化爬行速率，但在许多应用程序中，它并不详尽。它适用于URL唯一，稳定且没有有状态功能的应用程序。
This strategy represents a trade-off between coverage and speed that is appropriate for typical applications.	该策略平衡了常见应用程序的覆盖范围和速度。
This test analyzes the distribution of characters used at each position within the token. If the sample is randomly generated, the distribution of characters employed is likely to be approximately uniform. At each position, the test computes the probability of the observed distribution arising if the tokens are random. The significance level at each position is the probability of the observed distribution of characters occurring, assuming that the sample is randomly generated.	分析令牌中每个位置使用的字符分布。如果随机生成样本，则使用的字符分布应该几乎是均匀的。在此测试中，对于每个位置，我们计算如果令牌是随机的，应该观察到的分布概率。当假设随机生成样本时，每个位置的显着性水平是字符分布发生的概率。
This test analyzes the distribution of ones and zeroes at each bit position. If the sample is randomly generated, the number of ones and zeroes is likely to be approximately equal. At each position, the test computes the probability of the observed distribution arising if the tokens are random. The significance level at each position is the probability of the observed number of ones and zeroes occurring, assuming that the sample is randomly generated.	分析每个位位置的1和0的分布。如果随机生成样本，则1和0的分布应该几乎是均匀的。在此测试中，对于每个位置，我们计算如果令牌是随机的，应该观察到的分布概率。假设样本是随机生成的，每个位置的显着性水平是观察到的出现次数0和1的概率。
This test analyzes the relationships between bits at different positions within the token. If the sample is randomly generated, a value at a given bit position is equally likely to be accompanied by a one or a zero at any other bit position. At each position, the test computes the probability of the relationships observed with bits at other positions arising if the tokens are random. To prevent arbitrary results, when a degree of correlation is observed between two bits, the test adjusts the significance level of the bit whose significance level is lower based on all of the other bit-level tests.	该测试分析令牌中不同位置的位之间的关系。如果随机生成样本，则特定位的值应近似等于其他位位置为0或1的概率。如果令牌是随机的，则测试计算在每个位置发生的观察到的其他位置位的概率。为了防止任意结果，如果在2比特之间观察到相关性，则在其他比特级测试中调整具有较低显着性水平的比特的比特的显着性水平。
This test analyzes the transitions between successive tokens in the sample. If the sample is randomly generated, a character appearing at a given position is equally likely to be followed in the next token by any one of the characters that is used at that position. At each position, the test computes the probability of the observed transitions arising if the tokens are random. The significance level at each position is the probability of the observed transitions occurring, assuming that the sample is randomly generated.	分析样本中连续令牌之间的转换。如果随机生成样本，则出现在某个位置的字符出现在同一位置的相同位置的概率，无论在过去的同一位置使用什么字符，无论在同一位置使用什么字符它应该是。在此测试中，对于每个位置，我们计算如果令牌是随机的，应该观察到的转移概率。假设样本是随机生成的，每个位置的显着性水平是观察到发生的转变的概率。
This test attempts to compress the bit sequence at each position using standard ZLIB compression. The results indicate the proportional reduction in the size of the bit sequence when it was compressed. A higher degree of compression indicates that the data is less likely to be randomly generated.	此测试尝试使用标准ZLIB压缩来压缩每个位置的位串。压缩时，位串大小按比例减小。高压缩率表示数据不是随机生成的。
This test divides the bit sequence at each position into consecutive, non-overlapping groups of four, and derives a four-bit number from each group. It then counts the number of occurrences of each of the 16 possible numbers, and performs a chi-square calculation to evaluate this distribution. If the sample is randomly generated, the distribution of four-bit numbers is likely to be approximately uniform. At each position, the test computes the probability of the observed distribution arising if the tokens are random. The significance level at each position is the probability of the observed distribution occurring, assuming that the sample is randomly generated.	将每个位置的位串分成四个连续的非重叠组，并从每个组中导出一个4位值。接下来，我们计算可能出现的16个数值的出现次数，并计算卡方以评估该分布。如果随机生成样本，则4位数的分布应该几乎是均匀的。在此测试中，对于每个位置，我们计算如果令牌是随机的，应该观察到的分布概率。如果我们假设样本是随机的，则每个位置的显着性水平是观察到的分布将发生的概率。
This test divides the bit sequence at each position into runs of consecutive bits which have the same value. It then counts the number of runs with a length of 1, 2, 3, 4, 5, and 6 and above. If the sample is randomly generated, the number of runs with each of these lengths is likely to be within a range determined by the size of the sample set. At each position, the test computes the probability of the observed runs occurring if the tokens are random. The significance level at each position is the probability of the observed runs occurring, assuming that the sample is randomly generated.	该测试将每个位置的位串分成一系列具有相同值的连续位。并计算连续数字1,2,3,4,5,6等。如果随机生成样品，则这些长度的每条链的数量应该几乎落在由样品组的大小确定的范围内。在此测试中，对于每个位置，我们计算如果令牌是随机的，应该观察的序列的概率。如果我们假设样本是随机的，则每个位置的显着性水平是观察到的序列发生的概率。
This test measures the longest run of bits with the same value at each bit position. If the sample is randomly generated, the longest run is likely to be within a range determined by the size of the sample set. At each position, the test computes the probability of the observed longest run arising if the tokens are random. The significance level at each position is the probability of the observed longest run occurring, assuming that the sample is randomly generated.	在每个位位置测量具有相同值的最长位序列。如果样本是随机生成的，则最长序列应该几乎落在由样本集大小确定的范围内。在该测试中，对于每个位置，我们计算如果令牌是随机的，应该观察到的最长序列概率。如果我们假设样本是随机的，则每个位置的显着性水平是观察到的最长序列将发生的概率。
This test performs a sophisticated analysis of the bit sequence at each position, and is capable of identifying evidence of non-randomness in some samples which pass the other statistical tests. The test works through the bit sequence and treats each series of consecutive numbers as coordinates in a multi-dimensional space. It plots a point in this space at each location determined by these co-ordinates. If the sample is randomly generated, the distribution of points within this space is likely to be approximately uniform; the appearance of clusters within the space indicates that the data is likely to be non-random. At each position, the test computes the probability of the observed distribution occurring if the tokens are random. The test is repeated for multiple sizes of number (between 1 and 8 bits) and for multiple numbers of dimensions (between 2 and 6). The significance level at each position is the probability of the observed results occurring, assuming that the sample is randomly generated.	该测试可以对每个位置的位序列进行高级分析，并找到通过其他统计测试的一些样本的非同态性的证据。该测试处理位串并将一系列连续数字视为多维空间的坐标。对于由这些坐标确定的每个位置，绘制空间中的点。如果样本被随机生成，点的这个空间中的分布应该是近似均匀的;如果能够在空间偏压是数据很可能不是随机的。在此测试中，对于每个位置，计算如果令牌是随机的，应该观察到的分布的发生概率。对于多个大小的数字（1到8位）和多个维度（2到6）重复该测试。如果我们假设样本是随机的，则每个位置的显着性水平是观察结果发生的概率。
This type of live task analyses HTTP messages and adds entries to the Target site map. Choose which items to add to the site map based on their type and URL.	此类实时任务分析HTTP消息，并向Target的站点地图添加条目。根据类型和网址，请选择要添加到Sitemap的项目。
This version of Burp requires a license key. To continue, please paste your license key below, or load it from file.	此版本的Burp需要许可证密钥。要继续，请粘贴下面的许可证密钥或从文件中读取。
This will clear all existing custom iterator settings	清除所有现有的自定义迭代器
This will close all Burp projects and shutdown - are you sure you want to exit?	关闭所有Burp项目并关闭 - 你确定要退出吗？
This will close all Burp windows - are you sure you want to exit?	关闭所有Burp窗口 - 你确定要退出吗？
This will enable other network users to use the proxy and view the proxy history.	其他网络用户将能够使用代理浏览代理历史记录。
This will exit the current attack	结束当前攻击
This will update the requests and responses in the macro definition with those made in this test. Are you sure you want to proceed?	此测试生成的请求和响应将在宏定义中更新。你确定要继续吗？
This wizard lets you remove certain information which Burp saves on your computer. Choose which items you would like to remove.	该向导将删除保存在计算机上的特定信息Burp。请选择您要删除的项目。
Throttle between requests (milliseconds):	请求之间的权重（ms）：
Time	时间
Time delays	延时
Time of day	时刻
Time requested	请求时间
Time running:	启动时间:
Time-delay checks	延迟检查
Timeout	超时
Timeouts	超时
Title	标题
To ProperName	仅限大写字母且无变化
To Propername	仅限大写字母和其他小写字母
To help us improve Burp, please report this bug and include the details below.	要改善Burp，请使用以下详细信息报告此错误。
To load this file, create a new Burp project, and then restore the state file in the normal way, via the Burp menu.	要读取此文件，请创建一个新的Burp项目并像往常一样从Burp菜单恢复状态文件。
To lower case	转换为小写
To monitor or troubleshoot the behavior of your session handling rules, you can use the sessions tracer to view in detail the results of processing each rule.	要监视会话处理规则的操作并进行故障排除，可以使用会话跟踪器显示每个规则的处理结果的详细信息。
To new tab	到新标签
To repeat this request in your browser, copy the URL below and paste into a browser that is configured to use Burp as its proxy.	要在浏览器中重新传输此请求，请将以下URL复制并粘贴到设置为使用Burp作为代理的浏览器中。
To run Python extensions, you must download the Jython standalone JAR, and configure its location in Burp Extender options.	要运行Python扩展，您需要下载Jython独立JAR文件并使用Burp Extender选项设置位置。
To run Ruby extensions, you must download the JRuby JAR file, and either configure its location in Burp Extender options, or load it on startup via the Java classpath.	要运行Ruby扩展，您需要下载JRuby的JAR文件并使用Burp Extender选项设置位置，或者在启动时通过Java类路径读取它。
To show this response in your browser, copy the URL below and paste into a browser that is configured to use Burp as its proxy.	要在浏览器中显示此响应，请将以下URL复制并粘贴到设置为使用Burp作为代理的浏览器中。
To take effect, you will need to restart Burp, and then install the new certificate in your browser.	要激活，您需要重新启动Burp并在浏览器中安装新证书。
To this IP address	到此IP地址
To this host	给此主机
To upper case	转换为大写
Toggle message interception	反转消息拦截
Token Analysis	令牌分析
Token Handling	令牌处理
Token Location Within Response	响应中令牌位置
Tokens loaded:	令牌加载：
Tolerate URL mismatch when matching parameters (use for URL-agnostic CRSF tokens)	在参数匹配时接受URL不匹配（用于独立于URL的CSRF令牌）
Tool	工具
Tools	工具
Tools Scope	工具范围
Top/bottom split	上下分割
Total cost:	总金额：
Total encodings	总编码数
Total number of parameters:	参数总数：
Transitions	迁移
Trigger login failures (using invalid username)	登录失败（使用非法用户名）
Try to decode automatically	尝试自动解码
Two updates are available. Please select the version and build that you want to download.	有两个更新。请选择您要下载的版本和版本。
Two-digit hex	2位十六进制数
Type	类型
Type a search term	输入搜索字词
Type character to insert (ASCII or hex code)	请输入要插入的字符（ASCII或十六进制代码）
Type index	输入索引
Type string to insert	请输入要插入的字符串
Type:	类型：
Types of item to add:	要添加的项目类型：
Typical severity	一般风险
URL Scope	URL范围
URL file path (required)	URL文件路径（必填）
URL of redirection target	要重定向的URL
URL parameter	网址参数
URL parameter values	URL的参数值
URL path filename	URL路径的文件名
URL path folder	URL路径文件夹
URL path folders	URL路径文件夹
URL query string	URL查询字符串
URL to body	来自URL的主体
URL to cookie	来自URL的Cookie
URL-decode	URL解码
URL-encode all characters	URL编码所有字符
URL-encode all characters (Unicode)	URL编码所有字符（Unicode）
URL-encode as you type	URL编码输入
URL-encode key characters	特殊字符的URL编码
URL-encode these characters:	URL编码这些字符：
URL-encoded form	URL编码表单
URLs in scope	在范围URL中
URLs to Scan	要扫描的URL
URLs to add:	要添加的网址：
Unable to load help - please email support@portswigger.net with details, including the location of this help button.	我无法加载帮助 - 请发送电子邮件至support@portswigger.net以获取此帮助按钮的位置等详细信息。
Unable to load library - check file is correct and device is installed	无法加载库 - 请检查文件是否正确并且设备是否已安装
Unauthorized Response	未经授权的响应
Uncheck all	全部解锁
Understand 100 Continue responses	100继续认可响应
Undock	分离
Unhide hidden form fields	强制显示隐藏表单字段
Unpack gzip / deflate	部署gzip / deflate
Unpack gzip / deflate in requests	展开请求的gzip / deflate
Unpack gzip / deflate in responses	展开响应gzip / deflate
Up	至顶
Update Content-Length	Content-Length更新
Update Content-Length header	更新Content-Length标头
Update all cookies except for:	更新所有其他Cookie：
Update all parameters except for:	更新所有其他参数：
Update config based on selection below	根据以下选择更新设置
Update current	更新当前状态
Update current request with cookies from session handling cookie jar	会话处理更新cookie jok cookie
Update current request with parameters matched from final macro response	使用宏的最后响应的匹配参数更新请求
Update license key	许可证密钥更新
Update macro	宏更新
Update now	现在更新
Update only the following cookies:	仅更新此Cookie：
Update only the following parameters:	仅更新此参数：
Update the first macro request with parameters matched from the response to the current request	使用当前请求的响应更新第一个宏请求的匹配参数
Update the original macro configuration with the requests and responses made in this test	将原始宏设置更新为此测试生成的请求和响应
Update was saved successfully.	更新已成功保存。
Updated:	更新:
Updating results	结果更新中
Upstream Proxy Servers	上行代理服务器
Usable Bits of Entropy	可用的熵位
Use Burp defaults	使用Burp的默认值
Use HTTP version 1.1	使用HTTP版本1.1
Use HTTP/1.0 in requests to server	使用HTTP / 1.0来请求服务器
Use HTTP/1.0 in responses to client	使用HTTP / 1.0响应客户端
Use HTTPS	使用HTTPS
Use Referer header	使用Referer标头
Use SOCKS proxy	使用SOCKS代理
Use a private Collaborator server:	使用私有Collaborator服务器：
Use a self-signed certificate	使用自签名证书
Use a specific character set:	使用指定的字符集：
Use advanced scope control	使用高级范围设置
Use all items with responses	使用所有响应项
Use built-in lists	使用内置列表
Use cookies from the session handling cookie jar in requests	使用会话处理cookie jar的cookie请求
Use current site map	使用当前站点地图
Use custom location:	使用指定位置：
Use custom protocols and ciphers	使用自定义协议和加密
Use custom scope	使用自定义范围
Use default attack configuration	使用默认攻击设置
Use default system temp directory	使用系统默认临时目录
Use denial-of-service mode (no results)	使用拒绝服务模式（无结果）
Use dynamic analysis techniques	使用动态分析方法
Use existing resource pool	使用现有资源池
Use font smoothing	使用字体平滑
Use intelligent attack selection	使用智能攻击选择
Use lower case alpha characters	使用小写字母
Use nested insertion points	使用嵌套插入点
Use only selected branches	仅使用选定的分支
Use options saved with project	使用项目中保存的选项
Use proxy server to connect	使用代理服务器进行连接
Use static analysis techniques	使用静态分析方法
Use suite scope [defined in Target tab]	使用整个范围[在目标选项卡上定义]
Use the configuration below to control which URLs this rule applies to.	设置规则适用的URL。
Use the configuration below to define the items that are included in the macro, and the order they will be issued. You can configure how parameters and cookies are handled for each item. You can also test the macro to confirm it is working correctly.	使用以下设置可以定义要包含在宏中的项目以及它们的发布顺序。您可以为每个项目设置参数和cookie处理方法。您还可以测试宏以查看它们是否正常工作。
Use the default Collaborator server	使用默认的Collaborator服务器
Use the default protocols and ciphers of your Java installation	使用默认协议和密码进行Java安装
Use the platform default	使用平台默认值
Use these settings to control which WebSockets messages are stalled for viewing and editing in the Intercept tab.	在拦截选项卡上停止并控制要显示和编辑的WebSocket消息。
Use these settings to control which responses are stalled for viewing and editing in the Intercept tab.	在拦截选项卡上停止并控制显示和编辑的响应。
Use these settings to monitor and control Burp Spider. To begin spidering, browse to the target application, then right-click one or more nodes in the target site map, and choose "Spider this host / branch".	我们监控和控制Burp Spider。要开始游览，请浏览目标应用程序，右键单击站点地图中的目标节点或节点，然后选择“将此主机/分支作为Spider运行”。
Use these settings to monitor and control the discovery session.	使用这些设置监视、控制和搜索会话。
Use this for other configurations	与其他设置一起使用
Use this function to test the macro and determine whether it is working as required.	使用此函数测试宏并检查它是否按请求工作。
User Interface	用户界面
User agents	用户代理
User options	用户选项
Username	用户名
Username generator	用户名生成器(Username generator)
Username:	用户名：
Usernames	用户名
Using Burp Suite	如何使用Burp Suite
Valid session	合法会话
Validate session only every	合法线程
Value	值
Value derived from	衍生值
Value:	值：
Variable:  start	变化：开始
Version:	版本：
View	视图
View details	显示细节
View release notes	显示发行说明
Vulnerability classifications [where applicable]	漏洞分类[如果适用]
Waiting	待机中
Waiting to pause	已暂停
Warning	警告
Warning: The CSRF form uses a different encoding type than the original request, and so the application may not process the request in the way required.	警告：由于CSRF表单使用与原始请求不同的编码，因此应用程序可能无法以指定的方式处理请求。
Warning: The XmlHttpRequest technique only works on modern browsers, and the browser will not display the response to the CSRF request. The request contains some non-standard headers which, if included in a cross-domain XHR, may cause the request to be pre-flighted, and so the attack may fail. These headers have been omitted in the PoC attack, to avoid pre-flighting. If the omitted headers are essential for the efficacy of the CSRF attack, you can manually add these to the PoC HTML.	警告：XmlHttpRequest方法仅适用于最新的浏览器，浏览器不显示CSRF请求的响应。如果跨域XHR在请求中包含非标准标头，则可能会发生预检请求，并且攻击可能会失败。省略这些头部以避免预检。如果头部缩写为有效的CSRF攻击是必不可少的，则可以手动将其添加到PoC HTML。
Warning: The XmlHttpRequest technique only works on modern browsers, and the browser will not display the response to the CSRF request. The request contains some non-standard headers which, if included in a cross-domain XHR, may cause the request to be pre-flighted, and so the attack may fail. These headers have been omitted in the PoC attack, to avoid pre-flighting. If the omitted headers are essential for the efficacy of the CSRF attack, you can manually add these to the PoC HTML. The request includes a Content-Type header with a non-standard value, which may cause the request to be pre-flighted, and so the attack may fail. If the non-standard header is not essential for the efficacy of the CSRF attack, you can try using a standard value in the Content-Type header instead.	警告：XmlHttpRequest方法仅适用于最新的浏览器，浏览器不显示CSRF请求的响应。如果跨域XHR在请求中包含非标准标头，则可能会发生预检请求，并且攻击可能会失败。省略这些头部以避免预检。如果头部缩写为有效的CSRF攻击是必不可少的，则可以手动将其添加到PoC HTML。由于请求中存在非标准值Content-Type标头，因此可能会生成预检请求，并且攻击可能会失败。如果非标准标头对CSRF攻击不是必不可少的，请尝试使用标准的Content-Type标头。
Warning: This tracer imposes a processing and storage overhead, and should only be used when troubleshooting issues with session handling rules.	警告：由于此跟踪器会在处理和存储上加载负载，因此它应仅用于对会话处理规则进行故障排除。
Was annotated	注释
Was intercepted	已被截获
Was modified	已被更改
Was not annotated	没有评论
Was not intercepted	没有被截获
Was not modified	没有改变
WebSockets history	WebSocket历史
Weeks	周
Welcome ...	欢迎......
Welcome to Burp Suite Community Edition. Use the options below to create or open a project.	欢迎使用Burp Suite社区版。选择是使用以下选项创建还是打开项目。暖风熏得游人醉，直把杭州作汴州。
Welcome to Burp Suite Free Edition. Use the options below to create or open a project.	欢迎来到Burp Suite免费版。选择是使用以下选项创建还是打开项目。暖风熏得游人醉，直把杭州作汴州。
Welcome to Burp Suite Professional. Use the options below to create or open a project.	欢迎使用Burp Suite专业版。选择是使用以下选项创建还是打开项目。暖风熏得游人醉，直把杭州作汴州。
When items are added to Target scope:	将项目添加到目标范围时：
When the same insertion point is observed in a large number of requests with no variation in results, perform a more efficient quick scan, for the following insertion point types:	如果在许多请求中存在相同的插入点且结果没有变化，我们将更有效，更快地扫描下一个插入点类型：
When you click "next", Burp will remove the specified items and then exit.	单击“下一步”删除指定的项目并退出。
Whitespace	空白
Window	窗口
Windows Classic	Windows经典版
With payload positions	包括有效载荷位置
With this content type	包括此内容类型
With this response code	此响应代码
Without payload positions	包括不包括有效载荷位置
Word compare	单词比较
Words	单词
XML / SOAP injection	XML / SOAP注入
Years	年
Yes	是的
You are editing the live config for a running attack. You should proceed with caution and consider pausing the attack while you make changes	您即将在攻击执行期间编辑实时设置。我们建议您在进行更改时仔细考虑并暂停攻击。
You can attempt to recover project data from the file if you believe it is actually a Burp project file. This will create a new project file that can be opened safely, and will recover as much data as possible from the original file.	实际上，对于Burp项目文件，您可以尝试恢复项目数据。这将创建一个可以安全打开的新项目文件，并从原始文件中存储尽可能多的数据。
You can choose to continue to load this project but should consider creating a backup copy of your project file before doing so.	您可以继续加载此项目，但请在执行此操作之前考虑创建项目文件的备份副本。
You can configure a more detailed scope configuration using either URL prefixes or advanced matching rules. Note that the URLs to scan must fall within the defined scope, and will still be used as the starting point for the crawl.	您可以使用URL前缀或详细匹配规则设置详细范围。请注意，要扫描的URL必须在定义的范围内，并将继续用作爬行的起点。
You can configure whether to automatically start new tasks as they are created.	您可以设置是否在创建任务时自动启动。
You can define one or more payload sets. The number of payload sets depends on the attack type defined in the Positions tab. Various payload types are available for each payload set, and each payload type can be customized in different ways.	您可以定义一个或多个有效载荷集。有效载荷集的数量取决于“位置”选项卡中定义的攻击类型。每个有效载荷集可以使用各种有效载荷类型，并且可以以各种方式定制每种有效载荷类型。
You can define rules to perform various processing tasks on each payload before it is used.	您可以定义在使用有效载荷之前对每个有效载荷执行各种处理任务的规则。
You can define session handling rules to make Burp perform specific actions when making HTTP requests. Each rule has a defined scope (for particular tools, URLs or parameters), and can perform actions such as adding session cookies, logging in to the application, or checking session validity. Before each request is issued, Burp applies in sequence each of the rules that are in-scope for the request.	定义会话处理规则，该规则会在生成HTTP请求时执行指定的操作。对于每个规则，定义范围（特定工具，URL，参数），执行操作，例如添加会话cookie，登录到应用程序，检查会话的有效性等。在发出每个请求之前，依次将每个规则应用于范围中的请求。
You can export your certificate and key for use in other tools, or in another installation of Burp. You can import a certificate and key to use in this installation of Burp. Note that you can also export the current certificate by visiting http://burp/cert in your browser.	您可以为其他工具和其他Burp实例导出此证书。您可以导入用于此Burp的证书和私钥。请注意，您还可以通过在浏览器中访问http：// burp / cert来导出当前证书。
You can help improve Burp by submitting anonymous feedback about Burp's performance.	发送关于Burp表现的匿名反馈可以促进Burp的改进。
You can restrict the rule to requests containing specific parameters if required.	如有必要，可以将规则限制为包含指定参数的请求。
You can use the Burp Extender APIs to create your own extensions to customize Burp's behavior.	使用Burp Extender的API，您可以创建自己的扩展来自定义Burp的功能。
You have added an item to Target scope. Do you want Burp Proxy to stop sending out-of-scope items to the history or other Burp tools?	项目已添加到目标范围。您是否要停止将未展开的项目发送到历史记录或其他Burp工具？
You must load at least 100 tokens	您需要加载至少100个令牌
You should be aware that if any testing is continued using multiple instances of Burp, then some Collaborator-based issues may be missed or incorrectly reported.	如果继续使用多个Burp实例进行测试，可能会错过或报告基于Collaborator的问题。
You should exercise caution when installing untrusted BApps.	安装不受信任的BApps时要小心。
Your current license is due to expire soon. Please visit https://portswigger.net/users/ to extend your license before it expires.	目前的许可证即将到期。请访问https://portswigger.net/users/并在许可证到期之前将其扩展。
Your license has expired, and Burp will shut down shortly unless the license is updated. Please save your work now, or update your license.	Burp立即关闭，直到许可证到期并续订许可证。请立即保存您的工作或更新您的许可证。
Your license has expired. Please obtain a new license key to continue.	许可证已过期。要继续，请获取新的许可证密钥。
Your license is successfully installed and activated.	许可证已成功安装并激活。
Your temporary directory contains the following folders which appear to have been previously generated by Burp. Would you like to delete these?	Burp之前认为创建的文件仍保留在临时目录中。你想删除它吗？
[NOT SELECTED]	[未选中]
body parameter	主体参数
bytes	字节
characters	文字
close	关闭
configuration	设定
consecutive audit checks fail, skip remaining checks in the current insertion point	如果审计检查连续失败，则跳过该插入点处的剩余检查
consecutive audit items fail	当审计项目连续失败时
consecutive insertion points fail, skip remaining insertion points, and flag audit item as failed	如果点插入点失败，则跳过剩余的插入点并将审计项标记为失败
consecutive requests time out	请求连续超时时
follow-up passes to retry failed operations	确认添加时间并重试失败的操作
follow-up passes to retry requests that timed out	检查添加时间并重试超时请求。
login	登录
milliseconds	毫秒
minute	分钟
minutes	分后
payloads	生成有效载荷
pool	池
requests	仅验证每个请求
seconds	秒
step	步长
unknown	未知
Are you sure you want to restore default payloads grep options?	您确定要将有效载荷grep选项重置为默认值吗？
Are you sure you want to restore default proxy interception options?	您确定要将代理拦截选项恢复为默认值吗？
Audit checks - passive	审计检查 - 被动
Binding	绑定
Check robots.txt	检查robots.txt
Choose a log file	请选择一个日志文件
Copy Burp's built-in payload lists to the selected directory	将Burp的内置有效内容列表复制到所选目录
Customize crawl strategy (use with caution)	自定义抓取策略（请谨慎使用）
Drop	丢弃
Edit request header	编辑请求标头
Edit resource pool	编辑资源池
Edit response interception rule	编辑响应拦截规则
Enable automatic project backup	激活自动项目备份
Encoded as ASCII hex	ASCII十六进制编码
Extension Details	扩展细节
Extension type:	扩展类型：
Fuzzing - quick	模糊 - 简单
Help	帮助
Highlight	高亮
Highlight request parameters	高亮请求参数
In-scope items only	仅范围内的项目
Include Burp Collaborator identifier in the project file	在项目文件中包含BurpCollaborator的标识符
JavaScript phases	JavaScript阶段
Light active	主动扫描（温和）
Live Active Scanning	实时主动扫描
Live capture (paused)	实时捕捉（暂停）
Load the display filter options	加载显示过滤器选项
Macros	宏
Perform a byte-level comparison of the two selected items	比较字节级别的所选两个项目
Pitchfork	音叉（Pitchfork）
Please select the folder for loading library JAR files	请选择要加载库JAR文件的文件夹
Proxy interception documentation	代理拦截文件
Response body	响应主体
Save spider engine options	保存蜘蛛引擎选项
Select font	请选择字体
Static	静止
The rule is not in-scope for any URLs.	此规则超出了所有URL的范围。
These settings let you configure Burp to automatically carry out platform authentication to destination web servers.	配置目标Web服务器以自动执行平台身份验证。
These settings let you configure where Burp stores its temporary files. Changes will take effect the next time Burp starts up.	设置Burp保存临时文件的位置。它将从下一个Burp创业公司反映出来。
These settings let you control how HTTP messages are displayed within the raw HTTP viewer/editor.	控制HTTP消息在原始HTTP查看器/编辑器中的显示方式。
This URL is outside the current target scope. Are you sure you want to schedule an active scan?	此URL超出了当前范围的范围。您确定要安排主动扫描吗？
This action invokes a Burp Extension to process the current request.	此操作调用Burp扩展来处理当前请求。
This project file was created by a different installation of Burp. You need to decide whether to take full ownership of the project.	这个项目文件是由另一个Burp创建的。您需要决定是否选择项目的完整所有权。
This will enable other network users to use the service.	其他网络用户将能够使用此服务。
Thorough	彻底的
Throttle (milliseconds):	阈值（ms）：
Unauthenticated crawl. Estimating time remaining...	抓取未经身份验证的状态。评估剩余时间......
Use cookies	cookie使用
Use cookies from Burp's cookie jar	使用Burp的Cookie jar的饼干
Use cookies from the session handling cookie jar	使用会话处理cookie jar的cookie
Use these settings to control which requests are stalled for viewing and editing in the Intercept tab.	在拦截选项卡上停止并控制显示或编辑的请求。
When following redirections, understand the following types:	在关注链接时，它会识别以下类型：
Certificate and private key from PKCS#12 keystore	来自PKCS＃12密钥库的证书和密钥
Certificate and private key in PKCS#12 keystore	PKCS＃12密钥库证书和密钥
Choose a PKCS#12 file	请选择PKCS＃12文件
Choose the PKCS#11 library file	请选择PKCS＃11库文件
Client SSL certificate (PKCS#12)	客户端SSL证书（PKCS＃12）
Discovered PKCS#11 library files are shown below. Select the library file for your device and click "Next".	检测到的PKCS＃11库文件显示如下。 请选择设备的库文件，然后单击“下一步”。
File (PKCS#12)	档案（PKCS＃12）
Hardware token or smart card (PKCS#11)	硬件令牌和智能卡（PKCS＃11）
Not a valid PKCS#11 library	它不是有效的PKCS＃11库
Passwords + digit	密码+数字
Select the file containing your PKCS#12 certificate, and enter the password for the certificate.	请选择包含PKCS＃12证书的文件，然后输入该证书的密码。
Select the locations where Burp will search for PKCS#11 library files, then click "Search". Subdirectories are automatically searched.	选择要搜索PKCS＃11库文件的位置，然后单击“搜索”。 子目录会自动搜索。
Specify the location of the PKCS#11 library file for your hardware token or smart card. This is a native code file that is installed with the software for your device (for example, a .DLL file on Windows).	请为硬件令牌和智能卡指定PKCS＃11库文件的位置。 它是随设备软件一起安装的本机代码文件（例如Windows.DLL文件）。
To change an action's hotkey, select it in the table and type the hotkey for that action. To clear an existing hotkey, press delete or escape. All hotkeys must use the Control key, and may also use Shift or other available modifiers. Note that on some Windows installations the Control+Alt combination is treated by the OS as equivalent to AltGr, and so may result in typed characters appearing when pressed in text fields.	要更改操作的热键，请从表中选择它并输入操作的热键。 要清除现有热键，请按Delete键或Esc键。 所有热键必须使用控制键，并且可以使用shift和其他修改键。 请注意，在某些Windows安装中，Ctrl + Alt的组合被视为等效于AltGr，因此可能会出现在文本字段中键入的字符。
Use a custom certificate (PKCS#12):	使用自定义证书（PKCS＃12）：
An error occurred: Not a valid Burp project file: (.*)	发生错误：它不是有效的Burp项目文件：$1
Analyzing input file: ([0-9]+)% complete	解析输入文件：完成 $1%
Are you sure you want to delete task ([0-9]+)?	您确定要删除$1任务？
Are you sure you want to delete task ([0-9]+)\?	您确定要删除$1任务？
Are you sure you want to delete the configuration "(.*)"\?	您确定要删除"$1"设置吗？
Are you sure you want to remove ("[^"]+")\?	$1您确定要删除吗？
Are you sure you want to unload ("[^"]+")\?	$1你确定要卸载吗？
At a significance level of 1%, the amount of effective entropy is estimated to be: ([0-9]+) bits.	1%在显着性水平，有效熵量的评估如下：$1 位
Auditing\. ([0-9]+)d remaining	审计中, 剩余$1日
Auditing\. ([0-9]+)h ([0-9]+)m ([0-9]+)s remaining	审计中, 剩余$1小时$2分$3秒
Auditing\. ([0-9]+)h remaining	审计中, 剩余$1时间
Auditing\. ([0-9]+)m ([0-9]+)s remaining	审计中, 剩余$1分$2秒
Auditing\. ([0-9]+)m remaining	审计中, 剩余$1分
Auditing\. ([0-9]+)s remaining	审计中, 剩余$1秒
Authenticated crawl \((.*)\). Estimating time remaining...	身份验证($1). 评估剩余时间....
Auto analyze \(next: ([0-9]+)\)	自动解析 (次: $1)
Automatic backup ([0-9]+)% complete	自动备份$1%完成
Base64-encoded data in parameter(\s+\[[0-9]+\])?	参数中的Base64编码数据$1
Because some character positions within the sample use character sets whose size is not a round power of two, ([,0-9.]+) bits of data were compressed into other bits derived from the same character position.	由于样本中的一些字符位置使用的字符集的大小不是2的整数次方，$1 位数据被压缩成来自相同字符位置的其他位。
Browser cross-site scripting filter disabled(\s+\[[0-9]+\])?	浏览器XSS过滤器无效$1
Byte compare of #([0-9]+) and #([0-9]+)  \(([0-9]+) differences\)	#$1和#$2的字节比较($3个的不同)
CSS injection \(reflected\)(\s+\[[0-9]+\])?	CSS反射型$1
CSS injection \(stored\)(\s+\[[0-9]+\])?	CSS反射(储存型)$1
Cacheable HTTPS response(\s+\[[0-9]+\])?	可缓存HTTPS响应$1
Cleartext submission of password(\s+\[[0-9]+\])?	发送密码$1
Click the stars to rate the '(.*)' BApp	$1 请点击星星来评价BApp
Client-side HTTP parameter pollution \(reflected\)(\s+\[[0-9]+\])?	客户端侧HTTP参数污染(反射型)$1
Client-side HTTP parameter pollution \(stored\)(\s+\[[0-9]+\])?	客户端HTTP参数污染（存储型）$1
Client-side JSON injection \(DOM-based\)(\s+\[[0-9]+\])?	客户端JSON注入（基于DOM）$1
Client-side JSON injection \(reflected DOM-based\)(\s+\[[0-9]+\])?	客户端JSON注入（基于DOM反射型）$1
Client-side JSON injection \(stored DOM-based\)(\s+\[[0-9]+\])?	客户端JSON注入（基于DOM存储型）$1
Client-side SQL injection \(DOM-based\)(\s+\[[0-9]+\])?	客户端SQL注入（基于DOM）$1
Client-side SQL injection \(reflected DOM-based\)(\s+\[[0-9]+\])?	客户端SQL注入（基于DOM反射型）$1
Client-side SQL injection \(stored DOM-based\)(\s+\[[0-9]+\])?	客户端SQL注入（基于DOM存储型）$1
Client-side XPath injection \(DOM-based\)(\s+\[[0-9]+\])?	客户端XPath注入（基于DOM）$1
Client-side XPath injection \(reflected DOM-based\)(\s+\[[0-9]+\])?	客户端XPath注入（基于DOM反射型）$1
Client-side XPath injection \(stored DOM-based\)(\s+\[[0-9]+\])?	客户端XPath注入（基于DOM存储型）$1
Client-side template injection(\s+\[[0-9]+\])?	客户端模板注入$1
Collaborator (.*) interaction	Collaborator的$1通信
Comments search \| (https?://.*)	评论搜索| $1
Comparing site maps: ([0-9]+)% complete	比较站点地图： $1% 完成
Configuration "(.*)" has the same name as a built-in configuration.	设置"$1"与内置设置的名称相同。
Configuration "(.*)" is already present in the library.	库中已存在"$1"的设置。
Configure Macro Item: ([A-Z]+) request to (https?://.*)	配置宏项：$2 到 $1 请求
Content discovery: (https?://.*)	内容搜索：$1
Content type incorrectly stated(\s+\[[0-9]+\])?	内容类型不正确$1
Content type is not specified(\s+\[[0-9]+\])?	未指定内容类型$1
Cookie manipulation \(DOM-based\)(\s+\[[0-9]+\])?	Cookie操作(DOM基础)$1
Cookie manipulation \(reflected DOM-based\)(\s+\[[0-9]+\])?	Cookie操作(基于DOM反射型)$1
Cookie manipulation \(stored DOM-based\)(\s+\[[0-9]+\])?	Cookie操作(基于DOM存储型)$1
Cookie scoped to parent domain(\s+\[[0-9]+\])?	父域范围cookie$1
Cookie without HttpOnly flag set(\s+\[[0-9]+\])?	没有设置HttpOnly标志的cookie$1
Could not create file: (.*)	无法创建文件：$1
Could not load configuration from (.*)	无法从 $1 读取配置
Could not obtain lock on file: (.*)	无法获得文件锁定： $1
Credit card numbers disclosed(\s+\[[0-9]+\])?	信用卡号码泄漏$1
Cross-domain POST(\s+\[[0-9]+\])?	跨域POST$1
Cross-domain Referer leakage(\s+\[[0-9]+\])?	跨域Referer泄漏$1
Cross-domain script include(\s+\[[0-9]+\])?	跨域脚本加载$1
Cross-origin resource sharing(\s+\[[0-9]+\])?	跨源资源共享$1
Cross-origin resource sharing: all subdomains trusted(\s+\[[0-9]+\])?	跨源资源共享：信任所有子域$1
Cross-origin resource sharing: arbitrary origin trusted(\s+\[[0-9]+\])?	跨源资源共享：信任任何Origin$1
Cross-origin resource sharing: unencrypted origin trusted(\s+\[[0-9]+\])?	跨源资源共享：信任未加密的来源$1
Cross-site request forgery(\s+\[[0-9]+\])?	跨站请求伪造$1
Cross-site scripting \(DOM-based\)(\s+\[[0-9]+\])?	跨站点脚本（基于DOM）$1
Cross-site scripting \(reflected DOM-based\)(\s+\[[0-9]+\])?	跨站点脚本（基于DOM反射型）$1
Cross-site scripting \(reflected\)(\s+\[[0-9]+\])?	跨站点脚本（反射型）$1
Cross-site scripting \(stored DOM-based\)(\s+\[[0-9]+\])?	跨站点脚本（基于DOM存储型）$1
Cross-site scripting \(stored\)(\s+\[[0-9]+\])?	跨站点脚本（存储型）$1
DOM data manipulation \(DOM-based\)(\s+\[[0-9]+\])?	DOM数据操作（基于DOM）$1
DOM data manipulation \(reflected DOM-based\)(\s+\[[0-9]+\])?	DOM数据操作（基于DOM反射型）$1
DOM data manipulation \(stored DOM-based\)(\s+\[[0-9]+\])?	DOM数据操作（基于DOM存储型）$1
Database connection string disclosed(\s+\[[0-9]+\])?	数据库连接字符串泄漏$1
Deleted directory: (.*)	删除目录： $1
Denial of service \(DOM-based\)(\s+\[[0-9]+\])?	拒绝服务（基于DOM）$1
Denial of service \(reflected DOM-based\)(\s+\[[0-9]+\])?	拒绝服务（基于DOM反射型）$1
Denial of service \(stored DOM-based\)(\s+\[[0-9]+\])?	拒绝服务（基于DOM存储型）$1
Detach (.*)	$1断开
Detection methods: (.*)	检测方法：$1
Directory listing(\s+\[[0-9]+\])?	目录列表$1
Disk: (.*)	磁盘：$1
Document domain manipulation \(DOM-based\)(\s+\[[0-9]+\])?	文档域操作（基于DOM）$1
Document domain manipulation \(reflected DOM-based\)(\s+\[[0-9]+\])?	文档域操作（基于DOM反射型）$1
Document domain manipulation \(stored DOM-based\)(\s+\[[0-9]+\])?	文档域操作（基于DOM存储型）$1
Doing bit correlation test: bit ([0-9]+)	做位相关测试: bit $1
Doing character set tests: position ([0-9]+)	正在进行字符集测试：$1个字符
Doing spectral tests: bit ([0-9]+)	正在进行的频谱测试：bit $1
Download (JRuby|Jython)	$1下载
Downloading( \([0-9]+%\))?	在下载中$1
Duplicate cookies set(\s+\[[0-9]+\])?	重复cookie$1
Email addresses disclosed(\s+\[[0-9]+\])?	电子邮件地址泄漏$1
Expression Language injection(\s+\[[0-9]+\])?	表达式语言注入$1
Extension file \(\.(jar|py|rb)\):	扩展文件(.$1):
Extension generated issue(\s+\[[0-9]+\])?	使用扩展创建的问题$1
External service interaction \(DNS\)(\s+\[[0-9]+\])?	与外部服务（DNS）通信$1
External service interaction \(HTTP\)(\s+\[[0-9]+\])?	与外部服务（HTTP）通信$1
External service interaction \(SMTP\)(\s+\[[0-9]+\])?	与外部服务（SMTP）通信$1
Failed to connect to (.*:[0-9]+)	$1无法连接
Failed to create Burp project:(.*)	无法创建Burp项目：$1
Failed to delete directory: (.*)	目录无法删除：$1
Failed to import certificate: (.*)	无法导入证书： $1
Failed to load certificate: (.*)	无法加载证书：$1
File path manipulation(\s+\[[0-9]+\])?	文件路径操作$1
File path traversal(\s+\[[0-9]+\])?	文件路径遍历$1
File size: ([0-9,]+) bytes?	文件大小: $1 字节
File upload functionality(\s+\[[0-9]+\])?	文件上传功能$1
Flash cross-domain policy(\s+\[[0-9]+\])?	Flash跨域策略$1
Form action hijacking \(reflected\)(\s+\[[0-9]+\])?	表格动作劫持（反射型）$1
Form action hijacking \(stored\)(\s+\[[0-9]+\])?	表格行动劫持（存储型）$1
Frameable response \(potential Clickjacking\)(\s+\[[0-9]+\])?	可响应的响应（潜在的点击劫持）$1
Frameable responses \("Clickjacking"\)(\s+\[[0-9]+\])?	可响应的响应（“点击劫持”）$1
Generating report: ([0-9]+)% complete	报告正在生成: $1%已完成
HTML does not specify charset(\s+\[[0-9]+\])?	没有指定字符代码的HTML$1
HTML uses unrecognized charset(\s+\[[0-9]+\])?	具有无法识别的字符集的HTML$1
HTML5 cross-origin resource sharing(\s+\[[0-9]+\])?	HTML5跨源资源共享$1
HTML5 storage manipulation \(DOM-based\)(\s+\[[0-9]+\])?	HTML5存储操作（基于DOM）$1
HTML5 storage manipulation \(reflected DOM-based\)(\s+\[[0-9]+\])?	HTML5存储操作（基于DOM反射型）$1
HTML5 storage manipulation \(stored DOM-based\)(\s+\[[0-9]+\])?	HTML5存储操作（基于DOM存储型）$1
HTML5 web message manipulation \(DOM-based\)(\s+\[[0-9]+\])?	HTML5 Web消息操作（基于DOM）$1
HTML5 web message manipulation \(reflected DOM-based\)(\s+\[[0-9]+\])?	HTML5 Web消息操作（基于DOM反射型）$1
HTML5 web message manipulation \(stored DOM-based\)(\s+\[[0-9]+\])?	HTML5 Web消息操作（基于DOM存储型）$1
HTTP PUT method is enabled(\s+\[[0-9]+\])?	HTTP PUT方法有效$1
HTTP TRACE method is enabled(\s+\[[0-9]+\])?	TRACE方法有效$1
HTTP response header injection(\s+\[[0-9]+\])?	HTTP响应头注入$1
Importing (.*) data: ([0-9]+)% complete	$1数据导入中: $2% 完成
Input returned in response \(reflected\)(\s+\[[0-9]+\])?	响应中包含的输入值（反射型）$1
Input returned in response \(stored\)(\s+\[[0-9]+\])?	响应中包含的输入值（存储型）$1
Invalid IP address:(.*)	无效的IP地址：$1
Invalid IP range:(.*)	非法IP范围：$1
Invalid JSON configuration found at:(.*)	找到不正确的JSON设置：$1
Invalid host:(.*)	非法主机：$1
Invalid hostname:(.*)	主机名错误：$1
Invalid regex:(.*)	非正式表达：$1
Items( \([0-9]+\))?	项目$1
JavaScript injection \(DOM-based\)(\s+\[[0-9]+\])?	JavaScript注入（基于DOM）$1
JavaScript injection \(reflected DOM-based\)(\s+\[[0-9]+\])?	JavaScript注入（基于DOM反射型）$1
JavaScript injection \(stored DOM-based\)(\s+\[[0-9]+\])?	JavaScript注入（基于DOM存储型）$1
LDAP injection(\s+\[[0-9]+\])?	LDAP注入$1
Length range: ([,0-9]+-[,0-9]+).	长度范围：$1
Length: ([,0-9]+)	长度： $1
Link manipulation \(DOM-based\)(\s+\[[0-9]+\])?	链接操作（基于DOM）$1
Link manipulation \(reflected DOM-based\)(\s+\[[0-9]+\])?	链接操作（基于DOM反射型）$1
Link manipulation \(reflected\)(\s+\[[0-9]+\])?	链接操作（反射型）$1
Link manipulation \(stored DOM-based\)(\s+\[[0-9]+\])?	链接操作（基于DOM存储型）$1
Link manipulation \(stored\)(\s+\[[0-9]+\])?	链接操作（存储型）$1
List items for position ([0-9]+)( \([0-9]+\))?	列出位置为$1的项目$2
Live capture \(([0-9]+) tokens\)	实时捕获 ($1tokens)
Loading map ([0-9]+): ([0-9]+)% complete	加载地图$1中: $2% 完成
Loading state file: ([0-9]+)% complete	加载状态文件: $1% 完成
Local file path manipulation \(DOM-based\)(\s+\[[0-9]+\])?	本地文件路径操作（基于DOM）$1
Local file path manipulation \(reflected DOM-based\)(\s+\[[0-9]+\])?	本地文件路径操作（基于DOM反射型）$1
Local file path manipulation \(stored DOM-based\)(\s+\[[0-9]+\])?	本地文件路径操作（基于DOM存储型）$1
Locating authenticated functionality \((.*)\). Estimating time remaining...	识别认证功能 ($1). 预计剩余时间......
Long redirection response(\s+\[[0-9]+\])?	长重定向响应$1
Macro ([0-9]+)	宏$1
Macro Recorder - Macro ([0-9]+)	宏记录器 - 宏$1
Map ([0-9])	地图$1
Memory: (.*)	内存: $1
Mixed content(\s+\[[0-9]+\])?	混合内容$1
Multiple content types specified(\s+\[[0-9]+\])?	指定多个竞争类型$1
Not a valid Burp project file: (.*)	它不是有效的Burp项目文件： $1
OS command injection(\s+\[[0-9]+\])?	OS命令注入$1
One bit failed the test \(bit ([0-9]+)\)\. All other bits passed the test\. 	有一点未通过测试(bit $1)。所有其他位都通过了测试
Open redirection \(DOM-based\)(\s+\[[0-9]+\])?	打开重定向（基于DOM）$1
Open redirection \(reflected DOM-based\)(\s+\[[0-9]+\])?	打开重定向（基于DOM反射型）$1
Open redirection \(reflected\)(\s+\[[0-9]+\])?	打开重定向（反射型）$1
Open redirection \(stored DOM-based\)(\s+\[[0-9]+\])?	打开重定向（基于DOM存储型）$1
Open redirection \(stored\)(\s+\[[0-9]+\])?	打开重定向（存储型）$1
Open redirection(\s+\[[0-9]+\])?	打开重定向$1
Out-of-band resource load \(HTTP\)(\s+\[[0-9]+\])?	读取带外资源（HTTP）$1
PHP code injection(\s+\[[0-9]+\])?	PHP代码注入$1
Password field with autocomplete enabled(\s+\[[0-9]+\])?	已启用自动填充的密码字段$1
Password returned in URL query string(\s+\[[0-9]+\])?	URL查询字符串中返回的密码$1
Password returned in later response(\s+\[[0-9]+\])?	在以后的响应中返回密码$1
Password submitted using GET method(\s+\[[0-9]+\])?	使用GET方法传输密码$1
Password value set in cookie(\s+\[[0-9]+\])?	为cookie设置的密码值$1
Path-relative style sheet import(\s+\[[0-9]+\])?	阅读相对路径的样式表$1
Paused due to error: ([0-9]+) consecutive audit items? have failed\.	由于错误导致中断：$1审计项目连续失败。
Perl code injection(\s+\[[0-9]+\])?	Perl代码注入$1
Private IP addresses disclosed(\s+\[[0-9]+\])?	私有IP地址泄露$1
Private key disclosed(\s+\[[0-9]+\])?	私钥漏泄$1
Project file (.*) already exists, do you want to overwrite it\?	项目文件 $1 已存在，您要覆盖它吗？
Python code injection(\s+\[[0-9]+\])?	Python代码注入$1
Reattach (.*)	$1重组
Recovering project data ([0-9]+)% complete	恢复项目数据$1%完成
References to (https?://.*)	$1 的参考
Referer-dependent response(\s+\[[0-9]+\])?	引用依赖的响应$1
Remove duplicate items \(same URL and parameters\) \[all ([0-9]+) items?\]	排除重复项（相同的URL和参数）项 [全$1项目]
Remove duplicate items \(same URL and parameters\)( \[([,0-9]+) items\])?	排除重复项（相同的URL和参数）项 [$2 项目]
Remove items already scanned \(same URL and parameters\)( \[([,0-9]+) items\])?	排除已扫描的项目（URL和参数相同） [$2 项目]
Remove items with media responses( \[([,0-9]+) items\])?	排除媒体响应[$2 项目]
Remove items with no parameters \[all ([0-9]+) items?\]	排除没有参数的项目 [全$1项目]
Remove items with no parameters( \[([,0-9]+) items\])?	排除没有参数的项目 [$2 项目]
Remove items with the following extensions \[([0-9]+) items?\]	排除扩展名 [$1项目]
Remove items with the following extensions \[all ([0-9]+) items?\]	排除扩展名 [全$1项目]
Remove items with the following extensions( \[([,0-9]+) items\])?	排除扩展名 [$2 项目]
Remove out-of-scope items \(based on current suite scope\) \[([0-9]+) items?\]	删除范围之外的项目（基于当前总体范围）[$1项目]
Remove out-of-scope items \(based on current suite scope\) \[all ([0-9]+) items?\]	删除范围外的项目（基于当前的总体范围）
Remove out-of-scope items( \[([,0-9]+) items\])?	排除范围外的项目 [$2 项目]
Report size: ([,0-9]+) bytes	报告大小：$1字节
Request ([0-9]+)	请求$1
Request URL override(\s+\[[0-9]+\])?	覆盖请求URL$1
Request to ([a-z].*)	$1 请求
Response ([0-9]+)	响应$1
Response from ([a-z].*)	$1 响应来自
Restoring: ([0-9]+)% complete	在还原过程中： $1%完成
Robots.txt file(\s+\[[0-9]+\])?	robots.txt文件 $1
Ruby code injection(\s+\[[0-9]+\])?	Ruby代码注入$1
Rule ([0-9]+)	ルール$1
Running \(([,0-9]+) active threads?\)	正在运行（活动线程数$1）
Running \(([0-9]+) active threads?, ([0-9]+) queued requests?\)	正在运行\（$1活动线程，$2排队请求\）
SMTP header injection(\s+\[[0-9]+\])?	SMTP标头注入$1
SQL injection \(second order\)(\s+\[[0-9]+\])?	SQL注入（二阶）$1
SQL injection(\s+\[[0-9]+\])?	SQL注入$1
SQL statement in request parameter(\s+\[[0-9]+\])?	请求参数中的SQL语句$1
SSL certificate(\s+\[[0-9]+\])?	SSL证书$1
SSL cookie without secure flag set(\s+\[[0-9]+\])?	未设置安全标志的SSL cookie$1
Sample size: ([0-9]+).	样本量：$1
Save successful: (.*)	成功保存： $1
Saving project ([0-9]+)% complete	保存项目： $1%
Saving: ([0-9]+)% complete	保存中: $1%完了
Scan item ([0-9]+) \| ([0-9]+) issues? \| ([0-9]+)% complete \| (.*)	扫描物品$1 | $2件问题 | $3%完成 | $4
Scan item ([0-9]+) \| ([0-9]+) issues? \| cancelled \| (.*)	扫描物品$1 | $2件问题 | 取消 | $3
Scan item ([0-9]+) \| ([0-9]+) issues? \| finished \| (.*)	扫描物品$1 | $2件问题 | 已完成 | $3
Scan item ([0-9]+) \| ([0-9]+) issues? \| waiting \| (.*)	扫描物品$1 | $2件问题 | 待机中 | $3
Searching:(.*)	搜索:$1
Select item ([0-9]+):	选定的项目$1:
Select the detection methods that will be used when checking for (.*)\.	$1请选择用于检查的检测方法。
Send to (Comparer|Decoder|Intruder|Repeater|Sequencer|Spider)	发送给$1
Separator for position ([0-9]+)	定位$1分隔符
Serialized object in HTTP message(\s+\[[0-9]+\])?	HTTP消息中的序列化对象$1
Server-side JavaScript code injection(\s+\[[0-9]+\])?	服务器端JavaScript代码注入$1
Server-side template injection(\s+\[[0-9]+\])?	服务器端模板注入$1
Session handling action editor - (.*)	会话处理动作编辑器 - $1
Session token in URL(\s+\[[0-9]+\])?	URL中的会话令牌$1
Silverlight cross-domain policy(\s+\[[0-9]+\])?	Silverlight跨域策略$1
Site Map ([0-9]+)	网站地图$1
Social security numbers disclosed(\s+\[[0-9]+\])?	社会保险号码泄漏$1
Source code disclosure(\s+\[[0-9]+\])?	源代码泄漏$1
Spoofable client IP address(\s+\[[0-9]+\])?	不可访问的客户端IP地址$1
Strict transport security not enforced(\s+\[[0-9]+\])?	不适用严格的运输安全措施$1
Suspicious input transformation \(reflected\)(\s+\[[0-9]+\])?	可疑的输入值转换（反射类型）$1
Suspicious input transformation \(stored\)(\s+\[[0-9]+\])?	输入值的可疑转换（累积类型)$1
Target analyzer \| (https?://.*)	目标解析 | $1
Target: (http.*)	目标: $1
The analysis is based on a sample of ([0-9]+) tokens?. Based on the sample size, the reliability of the results is: (.*)	分析$1基于令牌样本。 根据样本量，可靠性如下： $2
The capture server hostname ([-_.0-9a-z]*) could not be resolved to an IP address. Ensure that an appropriate DNS entry exists for the server. No connections to the polling server at ([-_.0-9a-z]*) could be opened. The collaborator will not work in this configuration. 	捕获服务器主机名$1无法解析为IP地址。 确保存在适用于服务器的DNS条目。 我无法连接到投票服务器$2。 协作者无法使用此设置。
The chart shows the maximum bits of entropy available at each position, given the size of the character set used at that position. The total amount of possible entropy is ([.0-9]+) bits.	该图显示了在该位置使用的字符集大小给出的每个位置的最大熵位。 有效熵的总数是$1.
The overall quality of randomness within the sample is estimated to be: (.*)	推断样本中随机数的质量如下： $1
To enable bit-level analysis, each token was converted into a set of ([,0-9]+) bits.(.*)	要启用位级解析，每个令牌都转换为$1位的集合。 $2
To tab ([0-9]+)	标签$1至
To use (.*) extensions, you need to download (.*), and configure its location in Burp Extender options.	要使用$1扩展名下载$2并使用 Burp Extender选项设置其位置。
Token length: ([0-9]+).	令牌长度： $1
URL parameter( .+)?	网址参数$1
Unencrypted communications(\s+\[[0-9]+\])?	未加密的通信$1
Unidentified code injection(\s+\[[0-9]+\])?	未知的代码注入$1
Use the platform default \((.*)\)	使用平台默认（$1）
User agent-dependent response(\s+\[[0-9]+\])?	依赖于用户代理的响应$1
Value \[(.*)\]	值[$1]
Web cache posoning(\s+\[[0-9]+\])?	Web缓存污染$1
WebSocket hijacking \(DOM-based\)(\s+\[[0-9]+\])?	WebSocket劫持（DOM基础）$1
WebSocket hijacking \(reflected DOM-based\)(\s+\[[0-9]+\])?	WebSocket劫持（反射DOM基础）$1
WebSocket hijacking \(stored DOM-based\)(\s+\[[0-9]+\])?	WebSocket劫持（累积型DOM基础）$1
Windows installer \((32|64)-bit\)	Windows Installer ($1)
Word compare of #([0-9]+) and #([0-9]+)  \(([0-9]+) differences\)	#$1的#$2单词比较  ($3位置差异)
Word compare of responses from (.*)	$1 响应词比较
X-Forwarded-For dependent response(\s+\[[0-9]+\])?	X-Forwarded-For-dependent响应$1
X509 certificate for (.*)	$1X509证书
XML entity expansion(\s+\[[0-9]+\])?	部署XML实体$1
XML external entity injection(\s+\[[0-9]+\])?	XML外部实体注入$1
XML injection(\s+\[[0-9]+\])?	XML注入$1
XPath injection(\s+\[[0-9]+\])?	XPath注入$1
You have selected ([,0-9]+) items for active scanning. Before continuing, you can use the filters below to remove certain categories of items, to make your scanning more targeted and efficient.	活动扫描$1此项目已被选中。 在继续之前，您可以使用以下过滤器排除特定类别的项目，并创建更有针对性，更有效的扫描。
You have selected ([0-9]+) items? to scan. Before continuing, you can use the filters below to remove certain categories of items, to make your scanning more targeted and efficient.	用于扫描$1已选择项目。 在继续之前，您可以使用以下过滤器排除特定类别的项目，并创建更有针对性，更有效的扫描。
Your JRE appears to be version ([0-9.]+) from Oracle Corporation	JRE似乎是Oracle版本$1。
\[and ([0-9]+) more\]	[否则$1件]
bit ([0-9]+) is negatively correlated with bit ([0-9]+) \(matches: ([0-9]+), probability in a random sample: ([0-9.]+)%\)	比特$1与比特$2呈负相关（匹配：$3，随机样本中的概率：$4％）
bit ([0-9]+) is negatively correlated with bit ([0-9]+) \(matches: ([0-9]+), probability in a random sample: less than 0.0001%\)	比特$1与比特$2具有负相关（匹配：$3，随机样本中的概率：小于0.0001％）
bit ([0-9]+) is positively correlated with bit ([0-9]+) \(matches: ([0-9]+), probability in a random sample: ([0-9.]+)%\)	比特$1与比特$2正相关（匹配：$3，随机样本中的概率：$4％）
bit ([0-9]+) is positively correlated with bit ([0-9]+) \(matches: ([0-9]+), probability in a random sample: less than 0.0001%\)	比特$1与比特$2正相关（匹配：$3，随机样本中的概率：小于0.0001％）
bit ([0-9]+): ([0-9]+)-D test with ([0-9]+)-bit numbers, point (\([0-9,]+\)) is too dense \(count: ([0-9]+), probability in a random sample: ([0-9.]+)%\)	比特$1：$3（$2）比特数的维度测试，点（$4）太密集（次数：（$5），随机样本的概率：$6％）
bit ([0-9]+): ([0-9]+)-D test with ([0-9]+)-bit numbers, point (\([0-9,]+\)) is too dense \(count: ([0-9]+), probability in a random sample: less than 0.0001%\)	比特$1：$3 $2维测试的比特数，$4点密度太大（数字：$5，随机样本中的概率：小于0.0001％）
bit ([0-9]+): ([0-9]+)-D test with ([0-9]+)-bit numbers, point (\([0-9,]+\)) is too sparse \(count: ([0-9]+), probability in a random sample: ([0-9.]+)%\)	比特$1：$3比特数$2维度测试，点$4太稀疏（次数：$5，随机样本中的概率：$6％）
bit ([0-9]+): ([0-9]+)-D test with ([0-9]+)-bit numbers, point (\([0-9,]+\)) is too sparse \(count: ([0-9]+), probability in a random sample: less than 0.0001%\)	比特$1：$3比特数$ 2维度测试，点$4太稀疏（次数：$5，随机样本中的概率：小于0.0001％）
bit ([0-9]+): compressed to ([0-9.]+)% of original size	比特（$1）：压缩到原始大小（$2）％
body parameter( .+)	主体参数$1
character (.) is too common at position ([0-9]+) \(count: ([0-9]+), probability in a random sample: ([0-9.]+)%\)	字符位置的字符数（$1）太多（$2）（数字：（$3），随机样本中的概率：（$4）％）
character (.) is too common at position ([0-9]+) \(count: ([0-9]+), probability in a random sample: less than 0.0001%\)	字符位置的字符数（$1）太多（$2）（数字：（$3），随机样本的概率：小于0.0001％）
character (.) is too rare at position ([0-9]+) \(count: ([0-9]+), probability in a random sample: ([0-9.]+)%\)	字符位置（$2）的字符数（$1）太小（次数：（$3），随机样本中的概率：（$4）％）
character (.) is too rare at position ([0-9]+) \(count: ([0-9]+), probability in a random sample: less than 0.0001%\)	字符位置（$2）的字符数（$1）太小（数字：（$3，随机样本中的概率：小于0.0001％）...
chi-square value is too high at bit ([0-9]+) \(chi-square: ([,0-9.]+), probability in a random sample: ([0-9.]+)%\)	比特（$1）的卡方值太高（卡方：（$2），随机样本中的概率：（$3）％）
chi-square value is too high at bit ([0-9]+) \(chi-square: ([,0-9.]+), probability in a random sample: less than 0.0001%\)	位（$1）的卡方值太高（卡方：（$2），随机样本中的概率：小于0.0001％）
chi-square value is too low at bit ([0-9]+) \(chi-square: ([,0-9.]+), probability in a random sample: ([0-9.]+)%\)	bit $1 卡方值太低（卡方：（$2），随机样本的概率：（$3）％）
chi-square value is too low at bit ([0-9]+) \(chi-square: ([,0-9.]+), probability in a random sample: less than 0.0001%\)	bit $1 卡方值太低（卡方：（$ 2），随机样本的概率：小于0.0001％）
longest run is too long at bit ([0-9]+) \(length: ([0-9]+), probability in a random sample: ([0-9.]+)%\)	最长的比特序列（$1）太长（长度：（$2），随机样本的概率：（$3％）...
longest run is too long at bit ([0-9]+) \(length: ([0-9]+), probability in a random sample: less than 0.0001%\)	最长的位序列（$ 1）太长（长度：（$ 2），随机样本中的概率：小于0.0001％）
longest run is too short at bit ([0-9]+) \(length: ([0-9]+), probability in a random sample: ([0-9.]+)%\)	最长的比特序列（$1）太短（长度：（$2），随机样本的概率：（$3）％）
longest run is too short at bit ([0-9]+) \(length: ([0-9]+), probability in a random sample: less than 0.0001%\)	最长的位序列（$1）太短（长度：（$2，随机样本中的概率：小于0.0001％）...
no protocol: (.*)	无协议： $1
null: ([0-9]+)% complete	null: $1% 已完成
number of ([0-9]+)-bit runs is too large at bit ([0-9]+) \(count: ([0-9]+), probability in a random sample: ([0-9.]+)%\)	该位的$1位数（$2）太大（数字：（$3），随机样本中的概率：（$4）％）
number of ([0-9]+)-bit runs is too large at bit ([0-9]+) \(count: ([0-9]+), probability in a random sample: less than 0.0001%\)	该位（$2）中的（$1）位数太大（数字：（$3），随机样本中的概率：小于0.0001％）
number of ([0-9]+)-bit runs is too small at bit ([0-9]+) \(count: ([0-9]+), probability in a random sample: ([0-9.]+)%\)	该位（$2）中的（$1）位数太小（数字：（$3），随机样本中的概率：（$4）％）
number of ([0-9]+)-bit runs is too small at bit ([0-9]+) \(count: ([0-9]+), probability in a random sample: less than 0.0001%\)	该位（$2）中的（$1）位数太小（次数：（$3），随机样本中的概率：小于0.0001％）
requesting item ([0-9]+)	请求项目 $1
too few ones at bit ([0-9]+) \(count: ([0-9]+), probability in a random sample: ([0-9.]+)%\)	位数（$1）太少1（数字：（$2），随机样本中的概率：（$3）％）
too few ones at bit ([0-9]+) \(count: ([0-9]+), probability in a random sample: less than 0.0001%\)	位数（$1）太少1（次数：（$2），随机样本中的概率：小于0.0001％）
too many ones at bit ([0-9]+) \(count: ([0-9]+), probability in a random sample: ([0-9.]+)%\)	位数（$1）太多1（数字：（$2），随机样本中的概率：（$3）％）
too many ones at bit ([0-9]+) \(count: ([0-9]+), probability in a random sample: less than 0.0001%\)	位数（$1）太多1（次数：（$2），随机样本中的概率：小于0.0001％）
transition from (.) to (.) is too common at position ([0-9]+) \(count: ([0-9]+), probability in a random sample: ([0-9.]+)%\)	从（$1）到（$2）在角色位置（$3）的过渡发生了太多次（次数：（$4），随机样本中的概率：（$5）％）
transition from (.) to (.) is too common at position ([0-9]+) \(count: ([0-9]+), probability in a random sample: less than 0.0001%\)	在字符位置（$3）从（$1）到$（$2）的转换发生了太多次（次数：（$4），随机样本中的概率：小于0.0001％）
transition from (.) to (.) is too rare at position ([0-9]+) \(count: ([0-9]+), probability in a random sample: ([0-9.]+)%\)	在字符位置（$3）从（$1）到$（$2）的转换不会发生（次数：（$4），随机样本中的概率：（$5）％）
transition from (.) to (.) is too rare at position ([0-9]+) \(count: ([0-9]+), probability in a random sample: less than 0.0001%\)	在字符位置（$3）从（$1）到（$2）的转换不会发生（频率：（$4），随机样本中的概率：小于0.0001％）
Proxy	代理
Spider	蜘蛛
Scanner	扫描器
Intruder	攻击器
Repeater	重放器
Sequencer	定序器
Decoder	编码器
Comparer	对比器
Extender	插件扩展
Burp Suite (.*) (.*) - licensed to (.*)	Burp Suite $1 $2 - licensed to $3
